ABACK: SLATE CRACK WHACK QUACK ABACK 
ABASE: SLATE CHASE ERASE ABASE 
ABATE: SLATE CRATE ABATE 
ABBEY: SLATE RACER APNEA ABBEY 
ABBOT: SLATE TAUNT AFOOT ABBOT 
ABHOR: SLATE MARRY BRIAR ABHOR 
ABIDE: SLATE MAUVE ABODE ABIDE 
ABLED: SLATE LEGAL PALER ABLED 
ABODE: SLATE MAUVE ABODE 
ABORT: SLATE TAUNT AFOOT ABORT 
ABOUT: SLATE TAUNT AUDIT ABOUT 
ABOVE: SLATE MAUVE ABOVE 
ABUSE: SLATE PAUSE AMUSE ABUSE 
ABYSS: SLATE GASSY ABYSS 
ACORN: SLATE MARRY AGORA ADORN ACORN 
ACRID: SLATE MARRY APRON ACRID 
ACTOR: SLATE TAUNT ATTIC ACTOR 
ACUTE: SLATE HAUTE ACUTE 
ADAGE: SLATE GRAVE ADAGE 
ADAPT: SLATE TRAIT CHANT ADAPT 
ADEPT: SLATE CATER WHEAT AGENT ADEPT 
ADMIN: SLATE MARRY WOMAN ADMIN 
ADMIT: SLATE TAUNT AFOOT ADMIT 
ADOBE: SLATE MAUVE ABODE ADOBE 
ADOPT: SLATE TAUNT AFOOT ABORT ADOPT 
ADORE: SLATE MAUVE ABODE ADORE 
ADORN: SLATE MARRY AGORA ADORN 
ADULT: SLATE FATAL ADULT 
AFFIX: SLATE MARRY APING AVOID AFFIX 
AFIRE: SLATE MAUVE ABODE AFIRE 
AFOOT: SLATE TAUNT AFOOT 
AFOUL: SLATE CANAL AFOUL 
AFTER: SLATE CATER AFTER 
AGAIN: SLATE CRACK AGAIN 
AGAPE: SLATE GRAVE ADAGE AGAPE 
AGATE: SLATE CRATE ABATE AGATE 
AGENT: SLATE CATER WHEAT AGENT 
AGILE: SLATE CABLE AMPLE ANGLE AGILE 
AGING: SLATE MARRY APING AGING 
AGLOW: SLATE CANAL VILLA AGLOW 
AGONY: SLATE MARRY ANNOY AGONY 
AGORA: SLATE MARRY AGORA 
AGREE: SLATE MAUVE ABODE AFIRE AGREE 
AHEAD: SLATE RACER KNEAD AHEAD 
AIDER: SLATE RACER ANGER AMBER AIDER 
AISLE: SLATE FALSE AISLE 
ALARM: SLATE CLANK PLAID LLAMA ALARM 
ALBUM: SLATE ALOOF ALIGN ALLAY ALBUM 
ALERT: SLATE CLEAT ALERT 
ALGAE: SLATE ALIKE ALONE ALGAE 
ALIBI: SLATE ALOOF ALIGN ALIBI 
ALIEN: SLATE CLEAN ALIEN 
ALIGN: SLATE ALOOF ALIGN 
ALIKE: SLATE ALIKE 
ALIVE: SLATE ALIKE ALIVE 
ALLAY: SLATE ALOOF ALIGN ALLAY 
ALLEY: SLATE CLEAN ALLEY 
ALLOT: SLATE BLOAT ALLOT 
ALLOW: SLATE ALOOF ALLOY ALLOW 
ALLOY: SLATE ALOOF ALLOY 
ALOFT: SLATE BLOAT ALOFT 
ALONE: SLATE ALIKE ALONE 
ALONG: SLATE ALOOF ALOUD ALONG 
ALOOF: SLATE ALOOF 
ALOUD: SLATE ALOOF ALOUD 
ALPHA: SLATE ALOOF ALIGN ALLAY ALBUM ALPHA 
ALTAR: SLATE BLOAT ALTAR 
ALTER: SLATE CLEAT ALTER 
AMASS: SLATE CRASH AMASS 
AMAZE: SLATE GRAVE AWAKE AMAZE 
AMBER: SLATE RACER ANGER AMBER 
AMBLE: SLATE CABLE AMBLE 
AMEND: SLATE RACER KNEAD AMEND 
AMISS: SLATE GASSY AMISS 
AMITY: SLATE CATTY AUNTY AMITY 
AMONG: SLATE MARRY WOMAN AMONG 
AMPLE: SLATE CABLE AMPLE 
AMPLY: SLATE CANAL VILLA APPLY AMPLY 
AMUSE: SLATE PAUSE AMUSE 
ANGEL: SLATE LEGAL BAGEL ANGEL 
ANGER: SLATE RACER ANGER 
ANGLE: SLATE CABLE AMPLE ANGLE 
ANGRY: SLATE MARRY ANGRY 
ANGST: SLATE ARTSY ANGST 
ANIME: SLATE MAUVE ANIME 
ANKLE: SLATE CABLE AMPLE ANGLE ANKLE 
ANNEX: SLATE RACER APNEA ANNEX 
ANNOY: SLATE MARRY ANNOY 
ANNUL: SLATE CANAL ANNUL 
ANODE: SLATE MAUVE ABODE ANODE 
ANTIC: SLATE TAUNT ANTIC 
ANVIL: SLATE CANAL ANVIL 
AORTA: SLATE CATTY JUNTA AORTA 
APART: SLATE TRAIT CHART APART 
APHID: SLATE MARRY APING APHID 
APING: SLATE MARRY APING 
APNEA: SLATE RACER APNEA 
APPLE: SLATE CABLE AMPLE APPLE 
APPLY: SLATE CANAL VILLA APPLY 
APRON: SLATE MARRY APRON 
APTLY: SLATE FATAL APTLY 
ARBOR: SLATE MARRY BRIAR ARBOR 
ARDOR: SLATE MARRY BRIAR ARDOR 
ARENA: SLATE RACER BREAK ARENA 
ARGUE: SLATE MAUVE ARGUE 
ARISE: SLATE PAUSE ARISE 
ARMOR: SLATE MARRY ARMOR 
AROMA: SLATE MARRY ARMOR AROMA 
AROSE: SLATE PAUSE ARISE AROSE 
ARRAY: SLATE MARRY ARRAY 
ARROW: SLATE MARRY APRON ARROW 
ARSON: SLATE GASSY ARSON 
ARTSY: SLATE ARTSY 
ASCOT: SLATE ARTSY ASCOT 
ASHEN: SLATE ASHEN 
ASIDE: SLATE PAUSE ASIDE 
ASKEW: SLATE ASHEN ASKEW 
ASSAY: SLATE GASSY ASSAY 
ASSET: SLATE ASSET 
ATOLL: SLATE FATAL ATOLL 
ATONE: SLATE ATONE 
ATTIC: SLATE TAUNT ATTIC 
AUDIO: SLATE MARRY APING AVOID AUDIO 
AUDIT: SLATE TAUNT AUDIT 
AUGUR: SLATE MARRY BRIAR AUGUR 
AUNTY: SLATE CATTY AUNTY 
AVAIL: SLATE FRAIL QUAIL AVAIL 
AVERT: SLATE CATER TREAT AVERT 
AVIAN: SLATE MARRY APING AVIAN 
AVOID: SLATE MARRY APING AVOID 
AWAIT: SLATE TRAIT AWAIT 
AWAKE: SLATE GRAVE AWAKE 
AWARD: SLATE CRACK BOARD AWARD 
AWARE: SLATE GRAVE AWARE 
AWASH: SLATE CRASH QUASH GNASH AWASH 
AWFUL: SLATE CANAL AFOUL AWFUL 
AWOKE: SLATE MAUVE ABODE AWOKE 
AXIAL: SLATE CANAL MORAL PUPAL AXIAL 
AXIOM: SLATE MARRY WOMAN AXIOM 
AXION: SLATE MARRY APING AVIAN AXION 
AZURE: SLATE MAUVE AZURE 
BACON: SLATE MARRY CANON BACON 
BADGE: SLATE MAUVE BARGE BADGE 
BADLY: SLATE CANAL RALLY GAILY BADLY 
BAGEL: SLATE LEGAL BAGEL 
BAGGY: SLATE MARRY CANDY GAWKY BAGGY 
BAKER: SLATE RACER WAGER PAYER BAKER 
BALER: SLATE LEGAL PALER BALER 
BALMY: SLATE CANAL RALLY BALMY 
BANAL: SLATE CANAL BANAL 
BANJO: SLATE MARRY CANON BANJO 
BARGE: SLATE MAUVE BARGE 
BARON: SLATE MARRY BARON 
BASAL: SLATE BASAL 
BASIC: SLATE GASSY BASIN BASIS BASIC 
BASIL: SLATE BASAL BASIL 
BASIN: SLATE GASSY BASIN 
BASIS: SLATE GASSY BASIN BASIS 
BASTE: SLATE CASTE BASTE 
BATCH: SLATE TAUNT PATCH HATCH CATCH BATCH 
BATHE: SLATE ATONE BATHE 
BATON: SLATE TAUNT BATON 
BATTY: SLATE CATTY PATTY FATTY BATTY 
BAWDY: SLATE MARRY CANDY DADDY BAWDY 
BAYOU: SLATE MARRY BAYOU 
BEACH: SLATE BEADY BEACH 
BEADY: SLATE BEADY 
BEARD: SLATE BEADY BEARD 
BEAST: SLATE BEAST 
BEECH: SLATE FEVER BEECH 
BEEFY: SLATE FEVER BEEFY 
BEFIT: SLATE TENET DEBIT BEFIT 
BEGAN: SLATE RACER KNEAD BEGAN 
BEGAT: SLATE CATER WHEAT BEGAT 
BEGET: SLATE TENET BERET BEGET 
BEGIN: SLATE FEVER BEECH BEGIN 
BEGUN: SLATE FEVER BEECH BEGIN BEGUN 
BEING: SLATE FEVER BEECH BEGIN BEING 
BELCH: SLATE LEVEL BELLY BELCH 
BELIE: SLATE BELLE BELIE 
BELLE: SLATE BELLE 
BELLY: SLATE LEVEL BELLY 
BELOW: SLATE LEVEL BELLY BELCH BELOW 
BENCH: SLATE FEVER BEECH BENCH 
BERET: SLATE TENET BERET 
BERRY: SLATE FEVER MERRY BERRY 
BERTH: SLATE PETTY TEETH BERTH 
BESET: SLATE CREST UNSET BESET 
BETEL: SLATE MOTEL BETEL 
BEVEL: SLATE LEVEL REVEL BEVEL 
BEZEL: SLATE LEVEL REPEL JEWEL BEZEL 
BIBLE: SLATE BELLE BIBLE 
BICEP: SLATE FEVER BONEY BICEP 
BIDDY: SLATE CRONY DUMPY GIDDY BIDDY 
BIGOT: SLATE TIGHT DIGIT BIGOT 
BILGE: SLATE BELLE BULGE BILGE 
BILLY: SLATE GOLLY DILLY BILLY 
BINGE: SLATE PRICE BINGE 
BINGO: SLATE CRONY BINGO 
BIOME: SLATE PRICE BINGE BIOME 
BIRCH: SLATE CRONY BIRCH 
BIRTH: SLATE MIRTH BIRTH 
BISON: SLATE MISSY BISON 
BITTY: SLATE MIRTH DITTY BITTY 
BLACK: SLATE CLANK FLACK BLACK 
BLADE: SLATE BLARE BLADE 
BLAME: SLATE BLARE BLADE BLAME 
BLAND: SLATE CLANK BLAND 
BLANK: SLATE CLANK FLANK PLANK BLANK 
BLARE: SLATE BLARE 
BLAST: SLATE BLAST 
BLAZE: SLATE BLARE BLADE BLAME BLAZE 
BLEAK: SLATE CLEAN GLEAM BLEAK 
BLEAT: SLATE CLEAT BLEAT 
BLEED: SLATE ELDER BLEED 
BLEEP: SLATE ELDER BLEEP 
BLEND: SLATE ELDER BLEND 
BLESS: SLATE FLESH BLESS 
BLIMP: SLATE FLUNK BLOOM BLIMP 
BLIND: SLATE FLUNK BLIND 
BLINK: SLATE FLUNK CLINK BLINK 
BLISS: SLATE BLUSH BLISS 
BLITZ: SLATE CLOTH BLITZ 
BLOAT: SLATE BLOAT 
BLOCK: SLATE FLUNK CLOCK BLOCK 
BLOKE: SLATE GLOVE ELOPE CLONE BLOKE 
BLOND: SLATE FLUNK BLIND BLOND 
BLOOD: SLATE FLUNK BLOOM BLOOD 
BLOOM: SLATE FLUNK BLOOM 
BLOWN: SLATE FLUNK CLOWN BLOWN 
BLUER: SLATE ELDER FLIER BLUER 
BLUFF: SLATE FLUNK BLUFF 
BLUNT: SLATE FLINT BLUNT 
BLURB: SLATE FLUNK PLUMP BLURB 
BLURT: SLATE FLINT BLURT 
BLUSH: SLATE BLUSH 
BOARD: SLATE CRACK BOARD 
BOAST: SLATE TOAST COAST BOAST 
BOBBY: SLATE CRONY DOWDY HOBBY BOBBY 
BONEY: SLATE FEVER BONEY 
BONGO: SLATE CRONY BINGO BONGO 
BONUS: SLATE MISSY BONUS 
BOOBY: SLATE CRONY WOODY BOOZY BOOBY 
BOOST: SLATE FOIST BOOST 
BOOTH: SLATE MIRTH BOOTH 
BOOTY: SLATE MIRTH PUTTY BOOTY 
BOOZE: SLATE PRICE FUDGE BOOZE 
BOOZY: SLATE CRONY WOODY BOOZY 
BORAX: SLATE MARRY APRON BORAX 
BORNE: SLATE PRICE GORGE BORNE 
BOSOM: SLATE MISSY BOSOM 
BOSSY: SLATE MISSY FUSSY BOSSY 
BOTCH: SLATE TIGHT BUTCH BOTCH 
BOUGH: SLATE CRONY BUXOM BOUGH 
BOULE: SLATE BELLE BIBLE BUGLE BOULE 
BOUND: SLATE CRONY POUND BOUND 
BOWEL: SLATE LEVEL BOWEL 
BOXER: SLATE FEVER CIDER POWER BOXER 
BRACE: SLATE GRAVE BRAKE BRACE 
BRAID: SLATE CRACK BRAIN BRAID 
BRAIN: SLATE CRACK BRAIN 
BRAKE: SLATE GRAVE BRAKE 
BRAND: SLATE CRACK BRAIN BRAND 
BRASH: SLATE CRASH BRASH 
BRASS: SLATE CRASH GRASS BRASS 
BRAVE: SLATE GRAVE CRAVE BRAVE 
BRAVO: SLATE CRACK BRAIN BRAVO 
BRAWL: SLATE FRAIL CRAWL BRAWL 
BRAWN: SLATE CRACK BRAIN BRAWN 
BREAD: SLATE RACER BREAK BREAD 
BREAK: SLATE RACER BREAK 
BREED: SLATE FEVER CREED GREED BREED 
BRIAR: SLATE MARRY BRIAR 
BRIBE: SLATE PRICE BRINE BRIDE BRIBE 
BRICK: SLATE CRONY PRICK BRICK 
BRIDE: SLATE PRICE BRINE BRIDE 
BRIEF: SLATE FEVER BRIEF 
BRINE: SLATE PRICE BRINE 
BRING: SLATE CRONY BRINK BRING 
BRINK: SLATE CRONY BRINK 
BRINY: SLATE CRONY BRINY 
BRISK: SLATE MISSY BRISK 
BROAD: SLATE MARRY BRIAR BROAD 
BROIL: SLATE GOLLY BROIL 
BROKE: SLATE PRICE DROVE BROKE 
BROOD: SLATE CRONY BROOD 
BROOK: SLATE CRONY BROOD BROOM BROOK 
BROOM: SLATE CRONY BROOD BROOM 
BROTH: SLATE MIRTH FROTH BROTH 
BROWN: SLATE CRONY GROWN BROWN 
BRUNT: SLATE TIGHT COUNT BRUNT 
BRUSH: SLATE MISSY CROSS BRUSH 
BRUTE: SLATE WRITE BRUTE 
BUDDY: SLATE CRONY DUMPY BUDDY 
BUDGE: SLATE PRICE FUDGE BUDGE 
BUGGY: SLATE CRONY DUMPY BUGGY 
BUGLE: SLATE BELLE BIBLE BUGLE 
BUILD: SLATE GOLLY CHILL BUILD 
BUILT: SLATE BUILT 
BULGE: SLATE BELLE BULGE 
BULKY: SLATE GOLLY BULKY 
BULLY: SLATE GOLLY DILLY BULLY 
BUNCH: SLATE CRONY PUNCH BUNCH 
BUNNY: SLATE CRONY BUNNY 
BURLY: SLATE GOLLY DRYLY CURLY BURLY 
BURNT: SLATE TIGHT COUNT BURNT 
BURST: SLATE FOIST TRUST BURST 
BUSED: SLATE RISER NOSEY BUSED 
BUSHY: SLATE MISSY BUSHY 
BUTCH: SLATE TIGHT BUTCH 
BUTTE: SLATE WRITE QUOTE BUTTE 
BUXOM: SLATE CRONY BUXOM 
BUYER: SLATE FEVER CIDER POWER BUYER 
BYLAW: SLATE CANAL MOLAR BYLAW 
CABAL: SLATE CANAL CABAL 
CABBY: SLATE MARRY CANDY CABBY 
CABIN: SLATE MARRY CANON CABIN 
CABLE: SLATE CABLE 
CACAO: SLATE MARRY CANON CACAO 
CACHE: SLATE MAUVE BARGE CANOE CACHE 
CACTI: SLATE CATTY CACTI 
CADDY: SLATE MARRY CANDY CADDY 
CADET: SLATE CATER CADET 
CAGEY: SLATE RACER CAGEY 
CAIRN: SLATE MARRY CAIRN 
CAMEL: SLATE LEGAL PANEL HAZEL CAMEL 
CAMEO: SLATE RACER CAGEY CAMEO 
CANAL: SLATE CANAL 
CANDY: SLATE MARRY CANDY 
CANNY: SLATE MARRY CANDY CANNY 
CANOE: SLATE MAUVE BARGE CANOE 
CANON: SLATE MARRY CANON 
CAPER: SLATE RACER CAPER 
CAPUT: SLATE TAUNT CAPUT 
CARAT: SLATE TAUNT HABIT CARAT 
CARGO: SLATE MARRY BARON CARGO 
CAROL: SLATE CANAL CAROL 
CARRY: SLATE MARRY CARRY 
CARVE: SLATE MAUVE WAIVE CARVE 
CASTE: SLATE CASTE 
CATCH: SLATE TAUNT PATCH HATCH CATCH 
CATER: SLATE CATER 
CATTY: SLATE CATTY 
CAULK: SLATE CANAL CAULK 
CAUSE: SLATE PAUSE CAUSE 
CAVIL: SLATE CANAL CAROL CAVIL 
CEASE: SLATE CHASE CEASE 
CEDAR: SLATE RACER CEDAR 
CELLO: SLATE LEVEL BELLY HELLO CELLO 
CHAFE: SLATE GRAVE AWAKE PEACE CHAFE 
CHAFF: SLATE CRACK CHAIN CHAMP CHAFF 
CHAIN: SLATE CRACK CHAIN 
CHAIR: SLATE CRACK CHARD CHAIR 
CHALK: SLATE FRAIL KOALA CHALK 
CHAMP: SLATE CRACK CHAIN CHAMP 
CHANT: SLATE TRAIT CHANT 
CHAOS: SLATE CRASH CHAOS 
CHARD: SLATE CRACK CHARD 
CHARM: SLATE CRACK CHARD CHARM 
CHART: SLATE TRAIT CHART 
CHASE: SLATE CHASE 
CHASM: SLATE CRASH CHASM 
CHEAP: SLATE RACER OCEAN CHEAP 
CHEAT: SLATE CATER CHEAT 
CHECK: SLATE FEVER ENEMY CHECK 
CHEEK: SLATE FEVER BONEY CHEEK 
CHEER: SLATE FEVER CIDER COWER CYBER CHEER 
CHESS: SLATE RISER CHESS 
CHEST: SLATE CREST CHEST 
CHICK: SLATE CRONY CHUCK CHICK 
CHIDE: SLATE PRICE CHIDE 
CHIEF: SLATE FEVER CHIEF 
CHILD: SLATE GOLLY CHILL CHILD 
CHILI: SLATE GOLLY CHILL CHILD CHILI 
CHILL: SLATE GOLLY CHILL 
CHIME: SLATE PRICE CHIDE CHIME 
CHINA: SLATE MARRY APING CHINA 
CHIRP: SLATE CRONY CHIRP 
CHOCK: SLATE CRONY CHOCK 
CHOIR: SLATE CRONY CHORD CHOIR 
CHOKE: SLATE PRICE CHOKE 
CHORD: SLATE CRONY CHORD 
CHORE: SLATE PRICE CURVE CHORE 
CHOSE: SLATE NOOSE CHOSE 
CHUCK: SLATE CRONY CHUCK 
CHUMP: SLATE CRONY CHUCK CHUMP 
CHUNK: SLATE CRONY CHUNK 
CHURN: SLATE CRONY CHURN 
CHUTE: SLATE WRITE QUOTE CHUTE 
CIDER: SLATE FEVER CIDER 
CIGAR: SLATE MARRY BRIAR CIGAR 
CINCH: SLATE CRONY CINCH 
CIRCA: SLATE MARRY APRON CIRCA 
CIVIC: SLATE CRONY CHUCK CIVIC 
CIVIL: SLATE GOLLY LURID CIVIL 
CLACK: SLATE CLANK CLACK 
CLAIM: SLATE CLANK CLAIM 
CLAMP: SLATE CLANK CLAIM CLAMP 
CLANG: SLATE CLANK CLANG 
CLANK: SLATE CLANK 
CLASH: SLATE CLASH 
CLASP: SLATE CLASH CLASS CLASP 
CLASS: SLATE CLASH CLASS 
CLEAN: SLATE CLEAN 
CLEAR: SLATE CLEAN CLEAR 
CLEAT: SLATE CLEAT 
CLEFT: SLATE FLEET CLEFT 
CLERK: SLATE ELDER CLERK 
CLICK: SLATE FLUNK CLOCK CLICK 
CLIFF: SLATE FLUNK CLIFF 
CLIMB: SLATE FLUNK BLOOM CLIMB 
CLING: SLATE FLUNK BLIND CLING 
CLINK: SLATE FLUNK CLINK 
CLOAK: SLATE ALOOF CLOAK 
CLOCK: SLATE FLUNK CLOCK 
CLONE: SLATE GLOVE ELOPE CLONE 
CLOSE: SLATE CLOSE 
CLOTH: SLATE CLOTH 
CLOUD: SLATE FLUNK CLOUD 
CLOUT: SLATE FLINT BLURT CLOUT 
CLOVE: SLATE GLOVE CLOVE 
CLOWN: SLATE FLUNK CLOWN 
CLUCK: SLATE FLUNK CLUCK 
CLUED: SLATE ELDER BLEED PLIED CLUED 
CLUMP: SLATE FLUNK PLUMP CLUMP 
CLUNG: SLATE FLUNK CLUNG 
COACH: SLATE CRACK COACH 
COAST: SLATE TOAST COAST 
COBRA: SLATE MARRY AGORA COBRA 
COCOA: SLATE MARRY APING COCOA 
COLON: SLATE GOLLY COLON 
COLOR: SLATE GOLLY COLON COLOR 
COMET: SLATE TENET COVET COMET 
COMFY: SLATE CRONY COMFY 
COMIC: SLATE CRONY COUCH COMIC 
COMMA: SLATE MARRY WOMAN COMMA 
CONCH: SLATE CRONY CONCH 
CONDO: SLATE CRONY CONCH CONIC CONDO 
CONIC: SLATE CRONY CONCH CONIC 
COPSE: SLATE NOOSE HOUSE POSSE COPSE 
CORAL: SLATE CANAL CORAL 
CORER: SLATE FEVER CIDER COWER CORER 
CORNY: SLATE CRONY CORNY 
COUCH: SLATE CRONY COUCH 
COUGH: SLATE CRONY COUCH COUGH 
COULD: SLATE GOLLY WOULD COULD 
COUNT: SLATE TIGHT COUNT 
COUPE: SLATE PRICE COUPE 
COURT: SLATE TIGHT COUNT COURT 
COVEN: SLATE FEVER COVEN 
COVER: SLATE FEVER ROVER COVER 
COVET: SLATE TENET COVET 
COVEY: SLATE FEVER COVEN COVEY 
COWER: SLATE FEVER CIDER COWER 
COYLY: SLATE GOLLY LOWLY COYLY 
CRACK: SLATE CRACK 
CRAFT: SLATE TRAIT GRAFT CRAFT 
CRAMP: SLATE CRACK CRAZY CRAMP 
CRANE: SLATE GRAVE BRAKE CRAZE CRANE 
CRANK: SLATE CRACK CRANK 
CRASH: SLATE CRASH 
CRASS: SLATE CRASH CRASS 
CRATE: SLATE CRATE 
CRAVE: SLATE GRAVE CRAVE 
CRAWL: SLATE FRAIL CRAWL 
CRAZE: SLATE GRAVE BRAKE CRAZE 
CRAZY: SLATE CRACK CRAZY 
CREAK: SLATE RACER CREAK 
CREAM: SLATE RACER CREAK CREAM 
CREDO: SLATE FEVER CREDO 
CREED: SLATE FEVER CREED 
CREEK: SLATE FEVER CREED CREEK 
CREEP: SLATE FEVER CREED CREEK CREEP 
CREME: SLATE PRICE CRONE CRUDE CREME 
CREPE: SLATE PRICE CREPE 
CREPT: SLATE TENET ERECT CREPT 
CRESS: SLATE RISER PRESS CRESS 
CREST: SLATE CREST 
CRICK: SLATE CRONY CRIMP CRICK 
CRIED: SLATE FEVER CREED CRIED 
CRIER: SLATE FEVER CIDER CRIER 
CRIME: SLATE PRICE CRIME 
CRIMP: SLATE CRONY CRIMP 
CRISP: SLATE MISSY BRISK CRISP 
CROAK: SLATE MARRY BRIAR GROAN CROAK 
CROCK: SLATE CRONY CROCK 
CRONE: SLATE PRICE CRONE 
CRONY: SLATE CRONY 
CROOK: SLATE CRONY CROCK CROOK 
CROSS: SLATE MISSY CROSS 
CROUP: SLATE CRONY CROCK CROWD CROUP 
CROWD: SLATE CRONY CROCK CROWD 
CROWN: SLATE CRONY CROWN 
CRUDE: SLATE PRICE CRONE CRUDE 
CRUEL: SLATE LEVEL BOWEL EXPEL CRUEL 
CRUMB: SLATE CRONY CRIMP CRUMB 
CRUMP: SLATE CRONY CRIMP CRUMP 
CRUSH: SLATE MISSY CROSS CRUSH 
CRUST: SLATE FOIST TRUST CRUST 
CRYPT: SLATE TIGHT COUNT CRYPT 
CUBIC: SLATE CRONY CHUCK CUBIC 
CUMIN: SLATE CRONY CINCH CUMIN 
CURIO: SLATE CRONY CURIO 
CURLY: SLATE GOLLY DRYLY CURLY 
CURRY: SLATE CRONY CURRY 
CURSE: SLATE NOOSE PURSE CURSE 
CURVE: SLATE PRICE CURVE 
CURVY: SLATE CRONY CURRY CURVY 
CUTIE: SLATE TRICE CUTIE 
CYBER: SLATE FEVER CIDER COWER CYBER 
CYCLE: SLATE BELLE WHILE CYCLE 
CYNIC: SLATE CRONY CYNIC 
DADDY: SLATE MARRY CANDY DADDY 
DAILY: SLATE CANAL RALLY GAILY DAILY 
DAIRY: SLATE MARRY HAIRY FAIRY DAIRY 
DAISY: SLATE GASSY DAISY 
DALLY: SLATE CANAL RALLY DALLY 
DANCE: SLATE MAUVE BARGE CANOE DANCE 
DANDY: SLATE MARRY CANDY HANDY DANDY 
DATUM: SLATE TAUNT DATUM 
DAUNT: SLATE TAUNT HAUNT DAUNT 
DEALT: SLATE DEALT 
DEATH: SLATE DEATH 
DEBAR: SLATE RACER DEBAR 
DEBIT: SLATE TENET DEBIT 
DEBUG: SLATE FEVER BEECH DEBUG 
DEBUT: SLATE TENET DEBIT DEBUT 
DECAL: SLATE LEGAL PEDAL DECAL 
DECAY: SLATE RACER PECAN DECAY 
DECOR: SLATE FEVER DECOR 
DECOY: SLATE FEVER BEECH DECOY 
DECRY: SLATE FEVER MERRY DECRY 
DEFER: SLATE FEVER DEFER 
DEIGN: SLATE FEVER BEECH DEIGN 
DEITY: SLATE PETTY DEITY 
DELAY: SLATE LEGAL RELAY DELAY 
DELTA: SLATE DELTA 
DELVE: SLATE BELLE DELVE 
DEMON: SLATE FEVER BEECH DEIGN DEMON 
DEMUR: SLATE FEVER DECOR DEMUR 
DENIM: SLATE FEVER BEECH DEIGN DENIM 
DENSE: SLATE NOOSE DENSE 
DEPOT: SLATE TENET DEBIT DEPOT 
DEPTH: SLATE PETTY DEPTH 
DERBY: SLATE FEVER MERRY PERKY DERBY 
DETER: SLATE TENET DETER 
DETOX: SLATE TENET RETRO DETOX 
DEUCE: SLATE PRICE FENCE DEUCE 
DEVIL: SLATE LEVEL DEVIL 
DIARY: SLATE CRACK BOARD DWARF DIARY 
DICEY: SLATE FEVER BONEY DICEY 
DIGIT: SLATE TIGHT DIGIT 
DILLY: SLATE GOLLY DILLY 
DIMLY: SLATE GOLLY DRYLY DIMLY 
DINER: SLATE FEVER CIDER DINER 
DINGO: SLATE CRONY BINGO DINGO 
DINGY: SLATE CRONY PINKY DINGY 
DIODE: SLATE PRICE BINGE DIODE 
DIRGE: SLATE PRICE DIRGE 
DIRTY: SLATE MIRTH DIRTY 
DISCO: SLATE MISSY BISON DISCO 
DITCH: SLATE TIGHT DITCH 
DITTO: SLATE MIRTH DITTY DITTO 
DITTY: SLATE MIRTH DITTY 
DIVER: SLATE FEVER ROVER DIVER 
DIZZY: SLATE CRONY DUMPY DIZZY 
DODGE: SLATE PRICE FUDGE WEDGE DODGE 
DODGY: SLATE CRONY DOWDY DODGY 
DOGMA: SLATE MARRY WOMAN DOGMA 
DOING: SLATE CRONY POUND DOING 
DOLLY: SLATE GOLLY DOLLY 
DONOR: SLATE CRONY DONOR 
DONUT: SLATE TIGHT COUNT DONUT 
DOPEY: SLATE FEVER BONEY DOPEY 
DOUBT: SLATE TIGHT COUNT DOUBT 
DOUGH: SLATE CRONY BUXOM DOUGH 
DOWDY: SLATE CRONY DOWDY 
DOWEL: SLATE LEVEL BOWEL DOWEL 
DOWNY: SLATE CRONY DOWNY 
DOWRY: SLATE CRONY WORRY DOWRY 
DOZEN: SLATE FEVER BONEY WOMEN DOZEN 
DRAFT: SLATE TRAIT GRAFT CRAFT DRAFT 
DRAIN: SLATE CRACK BRAIN GRAIN DRAIN 
DRAKE: SLATE GRAVE BRAKE DRAKE 
DRAMA: SLATE CRACK BRAIN GRAVY FRAUD DRAMA 
DRANK: SLATE CRACK DRANK 
DRAPE: SLATE GRAVE BRAKE CRAZE DRAPE 
DRAWL: SLATE FRAIL CRAWL BRAWL DRAWL 
DRAWN: SLATE CRACK BRAIN DRAWN 
DREAD: SLATE RACER BREAK DREAD 
DREAM: SLATE RACER BREAK DREAD DREAM 
DRESS: SLATE RISER PRESS CRESS DRESS 
DRIED: SLATE FEVER CREED PRIED DRIED 
DRIER: SLATE FEVER CIDER DRIER 
DRIFT: SLATE TIGHT PRINT DRIFT 
DRILL: SLATE GOLLY CHILL DRILL 
DRINK: SLATE CRONY BRINK DRINK 
DRIVE: SLATE PRICE BRINE GRIME DRIVE 
DROIT: SLATE TIGHT PRINT DROIT 
DROLL: SLATE GOLLY DROLL 
DRONE: SLATE PRICE DROVE DRONE 
DROOL: SLATE GOLLY BROIL DROOL 
DROOP: SLATE CRONY BROOD DROOP 
DROSS: SLATE MISSY CROSS DROSS 
DROVE: SLATE PRICE DROVE 
DROWN: SLATE CRONY GROWN BROWN DROWN 
DRUID: SLATE CRONY DRUID 
DRUNK: SLATE CRONY BRINK DRUNK 
DRYER: SLATE FEVER CIDER DRYER 
DRYLY: SLATE GOLLY DRYLY 
DUCHY: SLATE CRONY MUCKY DUCHY 
DULLY: SLATE GOLLY DILLY DULLY 
DUMMY: SLATE CRONY DUMPY DUMMY 
DUMPY: SLATE CRONY DUMPY 
DUNCE: SLATE PRICE FENCE DUNCE 
DUSKY: SLATE MISSY BUSHY DUSKY 
DUSTY: SLATE GUSTY DUSTY 
DUTCH: SLATE TIGHT BUTCH DUTCH 
DUVET: SLATE TENET COVET DUVET 
DWARF: SLATE CRACK BOARD DWARF 
DWELL: SLATE LEVEL DWELL 
DWELT: SLATE MOTEL KNELT DWELT 
DYING: SLATE CRONY DYING 
EAGER: SLATE RACER WAGER EAGER 
EAGLE: SLATE CABLE MAPLE LADLE EAGLE 
EARLY: SLATE LEGAL PALER EARLY 
EARTH: SLATE EARTH 
EASEL: SLATE EASEL 
EATEN: SLATE CATER EATEN 
EATER: SLATE CATER EATER 
EBONY: SLATE FEVER ENEMY EBONY 
ECLAT: SLATE PETAL ECLAT 
EDICT: SLATE TENET ERECT EVICT EDICT 
EDIFY: SLATE FEVER EDIFY 
EERIE: SLATE PRICE DIRGE EERIE 
EGRET: SLATE TENET COVET QUIET GREET EGRET 
EIGHT: SLATE TENET ERECT EIGHT 
EJECT: SLATE TENET ERECT EJECT 
EKING: SLATE FEVER ENEMY EKING 
ELATE: SLATE PLATE ELATE 
ELBOW: SLATE ELDER ELEGY ELFIN ELBOW 
ELDER: SLATE ELDER 
ELECT: SLATE FLEET ELECT 
ELEGY: SLATE ELDER ELEGY 
ELFIN: SLATE ELDER ELEGY ELFIN 
ELIDE: SLATE GLOVE ELUDE ELIDE 
ELITE: SLATE ELITE 
ELOPE: SLATE GLOVE ELOPE 
ELUDE: SLATE GLOVE ELUDE 
EMAIL: SLATE LEAKY EMAIL 
EMBED: SLATE FEVER BONEY EMBED 
EMBER: SLATE FEVER CIDER POWER BUYER EMBER 
EMCEE: SLATE PRICE CHOKE EMCEE 
EMPTY: SLATE PETTY EMPTY 
ENACT: SLATE REACT ENACT 
ENDOW: SLATE FEVER ENEMY ENDOW 
ENEMA: SLATE RACER KNEAD ENEMA 
ENEMY: SLATE FEVER ENEMY 
ENJOY: SLATE FEVER ENEMY ENJOY 
ENNUI: SLATE FEVER ENEMY ENDOW ENNUI 
ENSUE: SLATE NOOSE ENSUE 
ENTER: SLATE TENET ENTER 
ENTRY: SLATE TENET ENTRY 
ENVOY: SLATE FEVER ENVOY 
EPOCH: SLATE FEVER ENEMY EPOCH 
EPOXY: SLATE FEVER ENEMY EPOXY 
EQUAL: SLATE LEGAL EQUAL 
EQUIP: SLATE FEVER ENEMY EPOCH EQUIP 
ERASE: SLATE CHASE ERASE 
ERECT: SLATE TENET ERECT 
ERODE: SLATE PRICE DROVE ERODE 
ERROR: SLATE FEVER ERROR 
ERUPT: SLATE TENET ERECT ERUPT 
ESSAY: SLATE ASHEN ESSAY 
ESTER: SLATE CREST ESTER 
ETHER: SLATE TENET OTTER ETHER 
ETHIC: SLATE TENET ETHIC 
ETHOS: SLATE CREST FETUS ETHOS 
ETUDE: SLATE TRICE ETUDE 
EVADE: SLATE GRAVE EVADE 
EVENT: SLATE TENET INERT EVENT 
EVERY: SLATE FEVER EVERY 
EVICT: SLATE TENET ERECT EVICT 
EVOKE: SLATE PRICE FUDGE BOOZE EVOKE 
EXACT: SLATE REACT ENACT EXACT 
EXALT: SLATE DEALT EXALT 
EXCEL: SLATE LEVEL BOWEL EXPEL EXCEL 
EXERT: SLATE TENET ERECT EXERT 
EXILE: SLATE BELLE WHILE GUILE EXILE 
EXIST: SLATE CREST HEIST EXIST 
EXPEL: SLATE LEVEL BOWEL EXPEL 
EXTOL: SLATE MOTEL EXTOL 
EXTRA: SLATE CATER EXTRA 
EXULT: SLATE MOTEL KNELT EXULT 
EYING: SLATE FEVER ENEMY EYING 
FABLE: SLATE CABLE FABLE 
FACET: SLATE CATER FACET 
FAINT: SLATE TAUNT PAINT FAINT 
FAIRY: SLATE MARRY HAIRY FAIRY 
FAITH: SLATE CATTY FAITH 
FALSE: SLATE FALSE 
FANCY: SLATE MARRY CANDY FANCY 
FANNY: SLATE MARRY CANDY FANNY 
FARCE: SLATE MAUVE BARGE FARCE 
FATAL: SLATE FATAL 
FATTY: SLATE CATTY PATTY FATTY 
FAULT: SLATE FATAL FAULT 
FAUNA: SLATE MARRY CANON FAUNA 
FAVOR: SLATE MARRY RADAR VAPOR FAVOR 
FEAST: SLATE BEAST FEAST 
FECAL: SLATE LEGAL PEDAL FECAL 
FEIGN: SLATE FEVER FEIGN 
FELLA: SLATE LEGAL FELLA 
FELON: SLATE LEVEL BELLY FELON 
FEMME: SLATE PRICE FUDGE FEMME 
FEMUR: SLATE FEVER FEMUR 
FENCE: SLATE PRICE FENCE 
FERAL: SLATE LEGAL PEDAL FECAL FERAL 
FERRY: SLATE FEVER FERRY 
FETAL: SLATE PETAL FETAL 
FETCH: SLATE TENET RETRO FETCH 
FETID: SLATE TENET RETRO FETCH FETID 
FETUS: SLATE CREST FETUS 
FEVER: SLATE FEVER 
FEWER: SLATE FEVER FEWER 
FIBER: SLATE FEVER FINER FIBER 
FIBRE: SLATE PRICE DIRGE FIBRE 
FICUS: SLATE MISSY FICUS 
FIELD: SLATE LEVEL WIELD FIELD 
FIEND: SLATE FEVER FIEND 
FIERY: SLATE FEVER FIERY 
FIFTH: SLATE MIRTH FIFTH 
FIFTY: SLATE MIRTH DITTY FIFTY 
FIGHT: SLATE TIGHT MIGHT FIGHT 
FILER: SLATE LEVEL FILER 
FILET: SLATE MOTEL INLET FILET 
FILLY: SLATE GOLLY DILLY BILLY FILLY 
FILMY: SLATE GOLLY BULKY FILMY 
FILTH: SLATE LOFTY FILTH 
FINAL: SLATE CANAL ZONAL FINAL 
FINCH: SLATE CRONY PUNCH FINCH 
FINER: SLATE FEVER FINER 
FIRST: SLATE FOIST FIRST 
FISHY: SLATE MISSY FISHY 
FIXER: SLATE FEVER FINER FIBER FIXER 
FIZZY: SLATE CRONY DUMPY FIZZY 
FJORD: SLATE CRONY FJORD 
FLACK: SLATE CLANK FLACK 
FLAIL: SLATE CLANK PLAID FLAIL 
FLAIR: SLATE CLANK PLAID FLAIL FLAIR 
FLAKE: SLATE BLARE FLAME FLAKE 
FLAKY: SLATE CLANK FLAKY 
FLAME: SLATE BLARE FLAME 
FLANK: SLATE CLANK FLANK 
FLARE: SLATE BLARE FLARE 
FLASH: SLATE CLASH FLASH 
FLASK: SLATE CLASH FLASK 
FLECK: SLATE ELDER FLECK 
FLEET: SLATE FLEET 
FLESH: SLATE FLESH 
FLICK: SLATE FLUNK FLOCK FLICK 
FLIER: SLATE ELDER FLIER 
FLING: SLATE FLUNK FLING 
FLINT: SLATE FLINT 
FLIRT: SLATE FLINT FLIRT 
FLOAT: SLATE BLOAT FLOAT 
FLOCK: SLATE FLUNK FLOCK 
FLOOD: SLATE FLUNK FLOOD 
FLOOR: SLATE FLUNK FLOOD FLOOR 
FLORA: SLATE ALOOF FLORA 
FLOSS: SLATE BLUSH FLOSS 
FLOUR: SLATE FLUNK FLOUR 
FLOUT: SLATE FLINT FLOUT 
FLOWN: SLATE FLUNK FLOWN 
FLUFF: SLATE FLUNK FLUID FLUFF 
FLUID: SLATE FLUNK FLUID 
FLUKE: SLATE GLOVE ELUDE FLUME FLUKE 
FLUME: SLATE GLOVE ELUDE FLUME 
FLUNG: SLATE FLUNK FLUNG 
FLUNK: SLATE FLUNK 
FLUSH: SLATE BLUSH FLUSH 
FLUTE: SLATE ELITE FLUTE 
FLYER: SLATE ELDER FLIER FLYER 
FOAMY: SLATE CRACK AGAIN FOAMY 
FOCAL: SLATE CANAL LOCAL VOCAL FOCAL 
FOCUS: SLATE MISSY BONUS FOCUS 
FOGGY: SLATE CRONY DOWDY HOBBY FOGGY 
FOIST: SLATE FOIST 
FOLIO: SLATE GOLLY COLON FOLIO 
FOLLY: SLATE GOLLY DOLLY FOLLY 
FORAY: SLATE MARRY ARRAY FORAY 
FORCE: SLATE PRICE FORCE 
FORGE: SLATE PRICE GORGE FORGE 
FORGO: SLATE CRONY FUROR FORGO 
FORTE: SLATE WRITE ROUTE FORTE 
FORTH: SLATE MIRTH FORTH 
FORTY: SLATE MIRTH FORTY 
FORUM: SLATE CRONY FUROR FORUM 
FOUND: SLATE CRONY POUND BOUND FOUND 
FOYER: SLATE FEVER FINER FREER FOYER 
FRAIL: SLATE FRAIL 
FRAME: SLATE GRAVE BRAKE CRAZE DRAPE FRAME 
FRANK: SLATE CRACK DRANK PRANK FRANK 
FRAUD: SLATE CRACK BRAIN GRAVY FRAUD 
FREAK: SLATE RACER BREAK WREAK FREAK 
FREED: SLATE FEVER FREED 
FREER: SLATE FEVER FINER FREER 
FRESH: SLATE RISER PRESS FRESH 
FRIAR: SLATE MARRY BRIAR FRIAR 
FRIED: SLATE FEVER FREED FRIED 
FRILL: SLATE GOLLY CHILL DRILL FRILL 
FRISK: SLATE MISSY BRISK FRISK 
FRITZ: SLATE MIRTH FRITZ 
FROCK: SLATE CRONY FROCK 
FROND: SLATE CRONY PRONG FROND 
FRONT: SLATE TIGHT COUNT FRONT 
FROST: SLATE FOIST FROST 
FROTH: SLATE MIRTH FROTH 
FROWN: SLATE CRONY GROWN BROWN DROWN FROWN 
FROZE: SLATE PRICE DROVE BROKE FROZE 
FRUIT: SLATE TIGHT PRINT DROIT FRUIT 
FUDGE: SLATE PRICE FUDGE 
FUGUE: SLATE PRICE FUDGE FUGUE 
FULLY: SLATE GOLLY DILLY BULLY FULLY 
FUNGI: SLATE CRONY UNDID FUNGI 
FUNKY: SLATE CRONY PINKY FUNKY 
FUNNY: SLATE CRONY BUNNY FUNNY 
FUROR: SLATE CRONY FUROR 
FURRY: SLATE CRONY FURRY 
FUSSY: SLATE MISSY FUSSY 
FUZZY: SLATE CRONY DUMPY BUGGY FUZZY 
GAFFE: SLATE MAUVE BARGE GAFFE 
GAILY: SLATE CANAL RALLY GAILY 
GAMER: SLATE RACER WAGER GAYER GAMER 
GAMMA: SLATE MARRY GAMMA 
GAMUT: SLATE TAUNT CAPUT GAMUT 
GASSY: SLATE GASSY 
GAUDY: SLATE MARRY CANDY DADDY BAWDY GAUDY 
GAUGE: SLATE MAUVE GAUGE 
GAUNT: SLATE TAUNT HAUNT DAUNT GAUNT 
GAUZE: SLATE MAUVE GAUGE GAUZE 
GAVEL: SLATE LEGAL GAVEL 
GAWKY: SLATE MARRY CANDY GAWKY 
GAYER: SLATE RACER WAGER GAYER 
GAYLY: SLATE CANAL RALLY GAILY GAYLY 
GAZER: SLATE RACER WAGER GAYER GAMER GAZER 
GECKO: SLATE FEVER BEECH DECOY GECKO 
GEEKY: SLATE FEVER BEECH WEEDY GEEKY 
GEESE: SLATE NOOSE PURSE GEESE 
GENIE: SLATE PRICE BINGE GENIE 
GENRE: SLATE PRICE GORGE GENRE 
GHOST: SLATE FOIST GHOST 
GHOUL: SLATE GOLLY GROWL GHOUL 
GIANT: SLATE TRAIT GIANT 
GIDDY: SLATE CRONY DUMPY GIDDY 
GIPSY: SLATE MISSY GIPSY 
GIRLY: SLATE GOLLY GIRLY 
GIRTH: SLATE MIRTH BIRTH GIRTH 
GIVEN: SLATE FEVER COVEN GIVEN 
GIVER: SLATE FEVER ROVER DIVER GIVER 
GLADE: SLATE BLARE FLAME GLADE 
GLAND: SLATE CLANK BLAND GLAND 
GLARE: SLATE BLARE FLARE GLARE 
GLASS: SLATE CLASH FLASK GLASS 
GLAZE: SLATE BLARE FLAME GLADE GLAZE 
GLEAM: SLATE CLEAN GLEAM 
GLEAN: SLATE CLEAN GLEAN 
GLIDE: SLATE GLOVE GLIDE 
GLINT: SLATE FLINT GLINT 
GLOAT: SLATE BLOAT FLOAT GLOAT 
GLOBE: SLATE GLOVE GLOBE 
GLOOM: SLATE FLUNK BLOOM GLOOM 
GLORY: SLATE FLUNK BLOOM GLORY 
GLOSS: SLATE BLUSH FLOSS GLOSS 
GLOVE: SLATE GLOVE 
GLYPH: SLATE FLUNK BLOOM GLYPH 
GNASH: SLATE CRASH QUASH GNASH 
GNOME: SLATE PRICE FUDGE GNOME 
GODLY: SLATE GOLLY GODLY 
GOING: SLATE CRONY POUND GOING 
GOLEM: SLATE LEVEL FILER GOLEM 
GOLLY: SLATE GOLLY 
GONAD: SLATE MARRY APING GONAD 
GONER: SLATE FEVER CIDER POWER BOXER JOKER HOMER GONER 
GOODY: SLATE CRONY WOODY GOODY 
GOOEY: SLATE FEVER BONEY DOPEY GOOEY 
GOOFY: SLATE CRONY WOODY BOOZY GOOFY 
GOOSE: SLATE NOOSE GOOSE 
GORGE: SLATE PRICE GORGE 
GOUGE: SLATE PRICE FUDGE GOUGE 
GOURD: SLATE CRONY FUROR ROUGH GOURD 
GRACE: SLATE GRAVE GRAZE GRAPE GRACE 
GRADE: SLATE GRAVE GRAZE GRAPE GRACE GRADE 
GRAFT: SLATE TRAIT GRAFT 
GRAIL: SLATE FRAIL GRAIL 
GRAIN: SLATE CRACK BRAIN GRAIN 
GRAND: SLATE CRACK BRAIN GRAND 
GRANT: SLATE TRAIT GRAFT GRANT 
GRAPE: SLATE GRAVE GRAZE GRAPE 
GRAPH: SLATE CRACK BRAIN GRAVY GRAPH 
GRASP: SLATE CRASH GRASS GRASP 
GRASS: SLATE CRASH GRASS 
GRATE: SLATE CRATE GRATE 
GRAVE: SLATE GRAVE 
GRAVY: SLATE CRACK BRAIN GRAVY 
GRAZE: SLATE GRAVE GRAZE 
GREAT: SLATE CATER TREAT GREAT 
GREED: SLATE FEVER CREED GREED 
GREEN: SLATE FEVER CREED PREEN GREEN 
GREET: SLATE TENET COVET QUIET GREET 
GRIEF: SLATE FEVER BRIEF GRIEF 
GRILL: SLATE GOLLY GRILL 
GRIME: SLATE PRICE BRINE GRIME 
GRIMY: SLATE CRONY GRIMY 
GRIND: SLATE CRONY BRINK WRING GRIND 
GRIPE: SLATE PRICE GRIPE 
GROAN: SLATE MARRY BRIAR GROAN 
GROIN: SLATE CRONY GROWN GROIN 
GROOM: SLATE CRONY BROOD GROOM 
GROPE: SLATE PRICE GROPE 
GROSS: SLATE MISSY CROSS DROSS GROSS 
GROUP: SLATE CRONY BROOD GROUP 
GROUT: SLATE TIGHT GRUNT GROUT 
GROVE: SLATE PRICE DROVE GROVE 
GROWL: SLATE GOLLY GROWL 
GROWN: SLATE CRONY GROWN 
GRUEL: SLATE LEVEL BOWEL EXPEL CRUEL GRUEL 
GRUFF: SLATE CRONY DRUID GRUFF 
GRUNT: SLATE TIGHT GRUNT 
GUARD: SLATE CRACK BOARD AWARD GUARD 
GUAVA: SLATE CRACK AGAIN GUAVA 
GUESS: SLATE RISER CHESS GUESS 
GUEST: SLATE CREST GUEST 
GUIDE: SLATE PRICE OVINE GUIDE 
GUILD: SLATE GOLLY GRILL GUILD 
GUILE: SLATE BELLE WHILE GUILE 
GUILT: SLATE BUILT GUILT 
GUISE: SLATE NOOSE PURSE GUISE 
GULCH: SLATE GOLLY GULCH 
GULLY: SLATE GOLLY GULLY 
GUMBO: SLATE CRONY BUXOM GUMBO 
GUMMY: SLATE CRONY DUMPY GUMMY 
GUPPY: SLATE CRONY DUMPY PUPPY GUPPY 
GUSTO: SLATE GUSTY GUSTO 
GUSTY: SLATE GUSTY 
GYPSY: SLATE MISSY GYPSY 
HABIT: SLATE TAUNT HABIT 
HAIRY: SLATE MARRY HAIRY 
HALVE: SLATE CABLE VALVE HALVE 
HANDY: SLATE MARRY CANDY HANDY 
HAPPY: SLATE MARRY CANDY GAWKY HAPPY 
HARDY: SLATE MARRY HARDY 
HAREM: SLATE RACER HAREM 
HARPY: SLATE MARRY HARDY HARPY 
HARRY: SLATE MARRY CARRY HARRY 
HARSH: SLATE GASSY MARSH HARSH 
HASTE: SLATE CASTE BASTE TASTE PASTE WASTE HASTE 
HASTY: SLATE PASTY TASTY HASTY 
HATCH: SLATE TAUNT PATCH HATCH 
HATER: SLATE CATER EATER WATER HATER 
HAUNT: SLATE TAUNT HAUNT 
HAUTE: SLATE HAUTE 
HAVEN: SLATE RACER OAKEN HAVEN 
HAVOC: SLATE MARRY CANON HAVOC 
HAZEL: SLATE LEGAL PANEL HAZEL 
HEADY: SLATE BEADY READY HEADY 
HEARD: SLATE BEADY HEARD 
HEART: SLATE REACT HEART 
HEATH: SLATE DEATH HEATH 
HEAVE: SLATE GRAVE WEAVE HEAVE 
HEAVY: SLATE BEADY WEARY HEAVY 
HEDGE: SLATE PRICE FUDGE WEDGE HEDGE 
HEFTY: SLATE PETTY DEITY HEFTY 
HEIST: SLATE CREST HEIST 
HELIX: SLATE LEVEL BELLY FELON RELIC HELIX 
HELLO: SLATE LEVEL BELLY HELLO 
HENCE: SLATE PRICE FENCE HENCE 
HERON: SLATE FEVER MERRY RERUN HERON 
HILLY: SLATE GOLLY DILLY BILLY FILLY WILLY HILLY 
HINGE: SLATE PRICE BINGE HINGE 
HIPPO: SLATE CRONY BUXOM HIPPO 
HIPPY: SLATE CRONY DUMPY HIPPY 
HITCH: SLATE TIGHT DITCH PITCH HITCH 
HOARD: SLATE CRACK BOARD HOARD 
HOBBY: SLATE CRONY DOWDY HOBBY 
HOIST: SLATE FOIST MOIST JOIST HOIST 
HOLLY: SLATE GOLLY DOLLY FOLLY HOLLY 
HOMER: SLATE FEVER CIDER POWER BOXER JOKER HOMER 
HONEY: SLATE FEVER BONEY HONEY 
HONOR: SLATE CRONY DONOR HONOR 
HORDE: SLATE PRICE GORGE BORNE HORDE 
HORNY: SLATE CRONY HORNY 
HORSE: SLATE NOOSE HOUSE HORSE 
HOTEL: SLATE MOTEL HOTEL 
HOTLY: SLATE BUILT TROLL HOTLY 
HOUND: SLATE CRONY POUND BOUND FOUND WOUND MOUND HOUND 
HOUSE: SLATE NOOSE HOUSE 
HOVEL: SLATE LEVEL HOVEL 
HOVER: SLATE FEVER ROVER COVER MOVER HOVER 
HOWDY: SLATE CRONY DOWDY HOWDY 
HUMAN: SLATE MARRY WOMAN HUMAN 
HUMID: SLATE CRONY HUMID 
HUMOR: SLATE CRONY FUROR RUMOR HUMOR 
HUMPH: SLATE CRONY HUMID HUMPH 
HUMUS: SLATE MISSY HUMUS 
HUNCH: SLATE CRONY PUNCH BUNCH MUNCH HUNCH 
HUNKY: SLATE CRONY PINKY FUNKY HUNKY 
HURRY: SLATE CRONY FURRY HURRY 
HUSKY: SLATE MISSY BUSHY HUSKY 
HUSSY: SLATE MISSY FUSSY HUSSY 
HUTCH: SLATE TIGHT BUTCH DUTCH HUTCH 
HYDRO: SLATE CRONY HYDRO 
HYENA: SLATE RACER KNEAD HYENA 
HYMEN: SLATE FEVER BONEY HYMEN 
HYPER: SLATE FEVER CIDER POWER HYPER 
ICILY: SLATE GOLLY DRYLY ICILY 
ICING: SLATE CRONY ICING 
IDEAL: SLATE LEGAL EQUAL IDEAL 
IDIOM: SLATE CRONY BUXOM IDIOM 
IDIOT: SLATE TIGHT PRINT IDIOT 
IDLER: SLATE LEVEL FILER IDLER 
IDYLL: SLATE GOLLY IDYLL 
IGLOO: SLATE GOLLY IGLOO 
ILIAC: SLATE ALOOF ILIAC 
IMAGE: SLATE GRAVE ADAGE IMAGE 
IMBUE: SLATE PRICE BINGE IMBUE 
IMPEL: SLATE LEVEL BOWEL EXPEL IMPEL 
IMPLY: SLATE GOLLY DRYLY ICILY IMPLY 
INANE: SLATE GRAVE AWAKE PEACE INANE 
INBOX: SLATE CRONY BINGO INBOX 
INCUR: SLATE CRONY INCUR 
INDEX: SLATE FEVER BONEY KNEED INDEX 
INEPT: SLATE TENET INERT INEPT 
INERT: SLATE TENET INERT 
INFER: SLATE FEVER INFER 
INGOT: SLATE TIGHT INGOT 
INLAY: SLATE CANAL INLAY 
INLET: SLATE MOTEL INLET 
INNER: SLATE FEVER CIDER INNER 
INPUT: SLATE TIGHT PRINT INPUT 
INTER: SLATE TENET ENTER INTER 
INTRO: SLATE TIGHT MOTIF INTRO 
IONIC: SLATE CRONY IONIC 
IRATE: SLATE CRATE GRATE IRATE 
IRONY: SLATE CRONY IRONY 
ISLET: SLATE ISLET 
ISSUE: SLATE NOOSE ISSUE 
ITCHY: SLATE TIGHT ITCHY 
IVORY: SLATE CRONY ROOMY IVORY 
JAUNT: SLATE TAUNT HAUNT DAUNT GAUNT JAUNT 
JAZZY: SLATE MARRY CANDY GAWKY HAPPY JAZZY 
JELLY: SLATE LEVEL BELLY JELLY 
JERKY: SLATE FEVER MERRY PERKY JERKY 
JETTY: SLATE PETTY JETTY 
JEWEL: SLATE LEVEL REPEL JEWEL 
JIFFY: SLATE CRONY DUMPY FIZZY JIFFY 
JOINT: SLATE TIGHT PRINT JOINT 
JOIST: SLATE FOIST MOIST JOIST 
JOKER: SLATE FEVER CIDER POWER BOXER JOKER 
JOLLY: SLATE GOLLY DOLLY FOLLY HOLLY JOLLY 
JOUST: SLATE FOIST BOOST WORST JOUST 
JUDGE: SLATE PRICE FUDGE BUDGE JUDGE 
JUICE: SLATE PRICE VOICE JUICE 
JUICY: SLATE CRONY MUCKY JUICY 
JUMBO: SLATE CRONY BUXOM GUMBO JUMBO 
JUMPY: SLATE CRONY DUMPY JUMPY 
JUNTA: SLATE CATTY JUNTA 
JUNTO: SLATE MIRTH PUTTY JUNTO 
JUROR: SLATE CRONY FUROR JUROR 
KAPPA: SLATE MARRY CANON VAPID KAPPA 
KARMA: SLATE MARRY KARMA 
KAYAK: SLATE MARRY BAYOU KAYAK 
KEBAB: SLATE RACER KNEAD KEBAB 
KHAKI: SLATE CRACK KHAKI 
KINKY: SLATE CRONY PINKY KINKY 
KIOSK: SLATE MISSY KIOSK 
KITTY: SLATE MIRTH DITTY BITTY WITTY KITTY 
KNACK: SLATE CRACK WHACK QUACK ABACK KNACK 
KNAVE: SLATE GRAVE WEAVE KNAVE 
KNEAD: SLATE RACER KNEAD 
KNEED: SLATE FEVER BONEY KNEED 
KNEEL: SLATE LEVEL BOWEL EXPEL CRUEL KNEEL 
KNELT: SLATE MOTEL KNELT 
KNIFE: SLATE PRICE OVINE KNIFE 
KNOCK: SLATE CRONY KNOCK 
KNOLL: SLATE GOLLY DROLL KNOLL 
KNOWN: SLATE CRONY KNOWN 
KOALA: SLATE FRAIL KOALA 
KRILL: SLATE GOLLY CHILL DRILL FRILL KRILL 
LABEL: SLATE LEGAL LAPEL LABEL 
LABOR: SLATE CANAL RALLY LABOR 
LADEN: SLATE LEGAL LAYER LADEN 
LADLE: SLATE CABLE MAPLE LADLE 
LAGER: SLATE LEGAL LAGER 
LANCE: SLATE CABLE LANCE 
LANKY: SLATE CANAL MANLY LANKY 
LAPEL: SLATE LEGAL LAPEL 
LAPSE: SLATE FALSE LAPSE 
LARGE: SLATE CABLE VALVE LARGE 
LARVA: SLATE CANAL RALLY LABOR LARVA 
LASSO: SLATE BASAL LASSO 
LATCH: SLATE FATAL LATCH 
LATER: SLATE PETAL LATER 
LATHE: SLATE TABLE LATHE 
LATTE: SLATE LATTE 
LAUGH: SLATE CANAL RALLY LAUGH 
LAYER: SLATE LEGAL LAYER 
LEACH: SLATE LEAKY LEARN LEACH 
LEAFY: SLATE LEAKY LEAFY 
LEAKY: SLATE LEAKY 
LEANT: SLATE DEALT LEANT 
LEAPT: SLATE DEALT LEANT LEAPT 
LEARN: SLATE LEAKY LEARN 
LEASE: SLATE LEASE 
LEASH: SLATE LEASH 
LEAST: SLATE LEAST 
LEAVE: SLATE WHALE LEAVE 
LEDGE: SLATE BELLE LEDGE 
LEECH: SLATE LEVEL LEERY LEECH 
LEERY: SLATE LEVEL LEERY 
LEFTY: SLATE LEFTY 
LEGAL: SLATE LEGAL 
LEGGY: SLATE LEVEL LEERY LEGGY 
LEMON: SLATE LEVEL LEERY LEMON 
LEMUR: SLATE LEVEL LEERY LEMUR 
LEPER: SLATE LEVEL LEPER 
LEVEL: SLATE LEVEL 
LEVER: SLATE LEVEL LEVER 
LIBEL: SLATE LEVEL LIBEL 
LIEGE: SLATE BELLE LUNGE LODGE LIEGE 
LIGHT: SLATE BUILT LIMIT LIGHT 
LIKEN: SLATE LEVEL LINEN LIKEN 
LILAC: SLATE CANAL LILAC 
LIMBO: SLATE GOLLY BROIL LIMBO 
LIMIT: SLATE BUILT LIMIT 
LINEN: SLATE LEVEL LINEN 
LINER: SLATE LEVEL LINEN LINER 
LINGO: SLATE GOLLY LINGO 
LIPID: SLATE GOLLY LURID LIPID 
LITHE: SLATE TITLE LITHE 
LIVER: SLATE LEVEL LIVER 
LIVID: SLATE GOLLY LURID LIPID LIVID 
LLAMA: SLATE CLANK PLAID LLAMA 
LOAMY: SLATE FRAIL KOALA LOAMY 
LOATH: SLATE LOATH 
LOBBY: SLATE GOLLY LOOPY LORRY LOBBY 
LOCAL: SLATE CANAL LOCAL 
LOCUS: SLATE LOCUS 
LODGE: SLATE BELLE LUNGE LODGE 
LOFTY: SLATE LOFTY 
LOGIC: SLATE GOLLY LOGIN LOGIC 
LOGIN: SLATE GOLLY LOGIN 
LOOPY: SLATE GOLLY LOOPY 
LOOSE: SLATE LOOSE 
LORRY: SLATE GOLLY LOOPY LORRY 
LOSER: SLATE LOSER 
LOUSE: SLATE LOOSE LOUSE 
LOUSY: SLATE LOCUS LOUSY 
LOVER: SLATE LEVEL LIVER LOVER 
LOWER: SLATE LEVEL LINEN LOWER 
LOWLY: SLATE GOLLY LOWLY 
LOYAL: SLATE CANAL MORAL LOYAL 
LUCID: SLATE GOLLY LURID LUCID 
LUCKY: SLATE GOLLY LUMPY LUCKY 
LUMEN: SLATE LEVEL LINEN LUMEN 
LUMPY: SLATE GOLLY LUMPY 
LUNAR: SLATE CANAL LUNAR 
LUNCH: SLATE GOLLY LURID LUNCH 
LUNGE: SLATE BELLE LUNGE 
LUPUS: SLATE LOCUS LUPUS 
LURCH: SLATE GOLLY LURID LURCH 
LURID: SLATE GOLLY LURID 
LUSTY: SLATE LUSTY 
LYING: SLATE GOLLY LYING 
LYMPH: SLATE GOLLY LYNCH LYMPH 
LYNCH: SLATE GOLLY LYNCH 
LYRIC: SLATE GOLLY LYNCH LYRIC 
MACAW: SLATE MARRY MANIA MACHO MACAW 
MACHO: SLATE MARRY MANIA MACHO 
MACRO: SLATE MARRY MACRO 
MADAM: SLATE MARRY MANIA MACHO MADAM 
MADLY: SLATE CANAL RALLY GAILY BADLY MADLY 
MAFIA: SLATE MARRY MANIA MAFIA 
MAGIC: SLATE MARRY MANIA MAGIC 
MAGMA: SLATE MARRY MANIA MAMMA MAGMA 
MAIZE: SLATE MAUVE MANGE MAIZE 
MAJOR: SLATE MARRY MANOR MAJOR 
MAKER: SLATE RACER WAGER PAYER BAKER MAKER 
MAMBO: SLATE MARRY MANIA MACHO MAMBO 
MAMMA: SLATE MARRY MANIA MAMMA 
MAMMY: SLATE MARRY MANGY MAMMY 
MANGA: SLATE MARRY MANIA MANGA 
MANGE: SLATE MAUVE MANGE 
MANGO: SLATE MARRY MANIA MANGO 
MANGY: SLATE MARRY MANGY 
MANIA: SLATE MARRY MANIA 
MANIC: SLATE MARRY MANIA MANIC 
MANLY: SLATE CANAL MANLY 
MANOR: SLATE MARRY MANOR 
MAPLE: SLATE CABLE MAPLE 
MARCH: SLATE MARRY MARCH 
MARRY: SLATE MARRY 
MARSH: SLATE GASSY MARSH 
MASON: SLATE GASSY BASIN MASON 
MASSE: SLATE PAUSE RAISE MASSE 
MATCH: SLATE TAUNT PATCH HATCH CATCH BATCH WATCH MATCH 
MATEY: SLATE CATER EATEN MATEY 
MAUVE: SLATE MAUVE 
MAXIM: SLATE MARRY MANIA MAGIC MAXIM 
MAYBE: SLATE MAUVE MANGE MAIZE MAYBE 
MAYOR: SLATE MARRY MAYOR 
MEALY: SLATE LEAKY MEALY 
MEANT: SLATE REACT MEANT 
MEATY: SLATE DEATH MEATY 
MECCA: SLATE RACER PECAN MECCA 
MEDAL: SLATE LEGAL PEDAL MEDAL 
MEDIA: SLATE RACER KNEAD MEDIA 
MEDIC: SLATE FEVER BEECH DECOY MEDIC 
MELEE: SLATE BELLE DELVE MELEE 
MELON: SLATE LEVEL BELLY FELON MELON 
MERCY: SLATE FEVER MERRY MERCY 
MERGE: SLATE PRICE GORGE VERGE MERGE 
MERIT: SLATE TENET DEBIT REFIT MERIT 
MERRY: SLATE FEVER MERRY 
METAL: SLATE PETAL FETAL METAL 
METER: SLATE TENET DETER METER 
METRO: SLATE TENET RETRO METRO 
MICRO: SLATE CRONY MICRO 
MIDGE: SLATE PRICE BINGE MIDGE 
MIDST: SLATE FOIST MIDST 
MIGHT: SLATE TIGHT MIGHT 
MILKY: SLATE GOLLY BULKY MILKY 
MIMIC: SLATE CRONY QUICK MIMIC 
MINCE: SLATE PRICE MINCE 
MINER: SLATE FEVER CIDER RIPER MINER 
MINIM: SLATE CRONY UNDID MINIM 
MINOR: SLATE CRONY DONOR MINOR 
MINTY: SLATE MIRTH MINTY 
MINUS: SLATE MISSY MINUS 
MIRTH: SLATE MIRTH 
MISER: SLATE RISER MISER 
MISSY: SLATE MISSY 
MOCHA: SLATE MARRY MOCHA 
MODAL: SLATE CANAL MORAL MODAL 
MODEL: SLATE LEVEL BOWEL MODEL 
MODEM: SLATE FEVER BONEY MODEM 
MOGUL: SLATE GOLLY LOGIN MOGUL 
MOIST: SLATE FOIST MOIST 
MOLAR: SLATE CANAL MOLAR 
MOLDY: SLATE GOLLY MOLDY 
MONEY: SLATE FEVER BONEY HONEY MONEY 
MONTH: SLATE MIRTH MONTH 
MOODY: SLATE CRONY WOODY GOODY MOODY 
MOOSE: SLATE NOOSE GOOSE MOOSE 
MORAL: SLATE CANAL MORAL 
MORON: SLATE CRONY DONOR MORON 
MORPH: SLATE CRONY FUROR MORPH 
MOSSY: SLATE MISSY MOSSY 
MOTEL: SLATE MOTEL 
MOTIF: SLATE TIGHT MOTIF 
MOTOR: SLATE TIGHT MOTOR 
MOTTO: SLATE MIRTH MOTTO 
MOULT: SLATE BUILT MOULT 
MOUND: SLATE CRONY POUND BOUND FOUND WOUND MOUND 
MOUNT: SLATE TIGHT COUNT MOUNT 
MOURN: SLATE CRONY DONOR MOURN 
MOUSE: SLATE NOOSE HOUSE ROUSE MOUSE 
MOUTH: SLATE MIRTH MONTH MOUTH 
MOVER: SLATE FEVER ROVER COVER MOVER 
MOVIE: SLATE PRICE BINGE MOVIE 
MOWER: SLATE FEVER CIDER POWER ROWER MOWER 
MUCKY: SLATE CRONY MUCKY 
MUCUS: SLATE MISSY MUCUS 
MUDDY: SLATE CRONY DUMPY MUDDY 
MULCH: SLATE GOLLY MULCH 
MUMMY: SLATE CRONY DUMPY GUMMY MUMMY 
MUNCH: SLATE CRONY PUNCH BUNCH MUNCH 
MURAL: SLATE CANAL MORAL MURAL 
MURKY: SLATE CRONY FURRY MURKY 
MUSHY: SLATE MISSY MUSKY MUSHY 
MUSIC: SLATE MISSY MUSIC 
MUSKY: SLATE MISSY MUSKY 
MUSTY: SLATE GUSTY DUSTY MUSTY 
MYRRH: SLATE CRONY MYRRH 
NADIR: SLATE MARRY RADAR NADIR 
NAIVE: SLATE MAUVE WAIVE NAIVE 
NANNY: SLATE MARRY CANDY FANNY NANNY 
NASAL: SLATE BASAL NASAL 
NASTY: SLATE PASTY TASTY HASTY NASTY 
NATAL: SLATE FATAL NATAL 
NAVAL: SLATE CANAL NAVAL 
NAVEL: SLATE LEGAL PANEL NAVEL 
NEEDY: SLATE FEVER BEECH WEEDY NEEDY 
NEIGH: SLATE FEVER BEECH WEIGH NEIGH 
NERDY: SLATE FEVER MERRY PERKY DERBY NERDY 
NERVE: SLATE PRICE GORGE VERVE NERVE 
NEVER: SLATE FEVER NEVER 
NEWER: SLATE FEVER NEWER 
NEWLY: SLATE LEVEL BELLY REPLY NEWLY 
NICER: SLATE FEVER CIDER NICER 
NICHE: SLATE PRICE NICHE 
NIECE: SLATE PRICE MINCE NIECE 
NIGHT: SLATE TIGHT MIGHT FIGHT RIGHT WIGHT NIGHT 
NINJA: SLATE MARRY APING NINJA 
NINNY: SLATE CRONY BUNNY NINNY 
NINTH: SLATE MIRTH FIFTH NINTH 
NOBLE: SLATE BELLE NOBLE 
NOBLY: SLATE GOLLY LOWLY COYLY NOBLY 
NOISE: SLATE NOOSE NOISE 
NOISY: SLATE MISSY NOISY 
NOMAD: SLATE MARRY WOMAN NOMAD 
NOOSE: SLATE NOOSE 
NORTH: SLATE MIRTH FORTH WORTH NORTH 
NOSEY: SLATE RISER NOSEY 
NOTCH: SLATE TIGHT BUTCH NOTCH 
NOVEL: SLATE LEVEL HOVEL NOVEL 
NUDGE: SLATE PRICE FUDGE BUDGE JUDGE NUDGE 
NURSE: SLATE NOOSE NURSE 
NUTTY: SLATE MIRTH PUTTY NUTTY 
NYLON: SLATE GOLLY NYLON 
NYMPH: SLATE CRONY NYMPH 
OAKEN: SLATE RACER OAKEN 
OBESE: SLATE NOOSE OBESE 
OCCUR: SLATE CRONY MICRO OCCUR 
OCEAN: SLATE RACER OCEAN 
OCTAL: SLATE FATAL TOTAL OCTAL 
OCTET: SLATE TENET COVET OCTET 
ODDER: SLATE FEVER CIDER UDDER ODDER 
ODDLY: SLATE GOLLY ODDLY 
OFFAL: SLATE CANAL MORAL OFFAL 
OFFER: SLATE FEVER INFER OFFER 
OFTEN: SLATE TENET ENTER OFTEN 
OLDEN: SLATE ELDER OLDEN 
OLDER: SLATE ELDER OLDER 
OLIVE: SLATE GLOVE OLIVE 
OMBRE: SLATE PRICE GORGE OMBRE 
OMEGA: SLATE RACER KNEAD OMEGA 
ONION: SLATE CRONY BINGO ONION 
ONSET: SLATE CREST UNSET ONSET 
OPERA: SLATE RACER BREAK OPERA 
OPINE: SLATE PRICE OPINE 
OPIUM: SLATE CRONY BUXOM OPIUM 
OPTIC: SLATE TIGHT MOTIF OPTIC 
ORBIT: SLATE TIGHT PRINT DROIT ORBIT 
ORDER: SLATE FEVER CIDER UDDER ORDER 
ORGAN: SLATE MARRY BRIAR GROAN ORGAN 
OTHER: SLATE TENET OTTER OTHER 
OTTER: SLATE TENET OTTER 
OUGHT: SLATE TIGHT OUGHT 
OUNCE: SLATE PRICE FENCE DUNCE OUNCE 
OUTDO: SLATE TIGHT MOTOR OUTDO 
OUTER: SLATE TENET OTTER OUTER 
OUTGO: SLATE TIGHT OUTGO 
OVARY: SLATE CRACK BOARD OVARY 
OVATE: SLATE CRATE ABATE OVATE 
OVERT: SLATE TENET ERECT OVERT 
OVINE: SLATE PRICE OVINE 
OVOID: SLATE CRONY WHOOP OVOID 
OWING: SLATE CRONY POUND OWING 
OWNER: SLATE FEVER CIDER POWER OWNER 
OXIDE: SLATE PRICE OVINE OXIDE 
OZONE: SLATE PRICE FUDGE BOOZE OZONE 
PADDY: SLATE MARRY CANDY DADDY PADDY 
PAGAN: SLATE MARRY CANON PAGAN 
PAINT: SLATE TAUNT PAINT 
PALER: SLATE LEGAL PALER 
PALSY: SLATE BASAL PALSY 
PANEL: SLATE LEGAL PANEL 
PANIC: SLATE MARRY CANON PANIC 
PANSY: SLATE GASSY DAISY PANSY 
PAPAL: SLATE CANAL PAPAL 
PAPER: SLATE RACER WAGER PAYER PAPER 
PARER: SLATE RACER WAGER PAYER PAPER PARER 
PARKA: SLATE MARRY BARON PARKA 
PARRY: SLATE MARRY CARRY HARRY PARRY 
PARSE: SLATE PAUSE PARSE 
PARTY: SLATE CATTY PARTY 
PASTA: SLATE PASTY PASTA 
PASTE: SLATE CASTE BASTE TASTE PASTE 
PASTY: SLATE PASTY 
PATCH: SLATE TAUNT PATCH 
PATIO: SLATE TAUNT PATCH PATIO 
PATSY: SLATE ARTSY PATSY 
PATTY: SLATE CATTY PATTY 
PAUSE: SLATE PAUSE 
PAYEE: SLATE MAUVE BARGE CANOE PAYEE 
PAYER: SLATE RACER WAGER PAYER 
PEACE: SLATE GRAVE AWAKE PEACE 
PEACH: SLATE BEADY REACH PEACH 
PEARL: SLATE LEAKY PEARL 
PECAN: SLATE RACER PECAN 
PEDAL: SLATE LEGAL PEDAL 
PENAL: SLATE LEGAL PEDAL PENAL 
PENCE: SLATE PRICE PENCE 
PENNE: SLATE PRICE PENNE 
PENNY: SLATE FEVER BEECH DEIGN PENNY 
PERCH: SLATE FEVER MERRY RERUN PERCH 
PERIL: SLATE LEVEL PERIL 
PERKY: SLATE FEVER MERRY PERKY 
PESKY: SLATE RISER PESKY 
PESTO: SLATE TESTY PESTO 
PETAL: SLATE PETAL 
PETTY: SLATE PETTY 
PHASE: SLATE CHASE PHASE 
PHONE: SLATE PRICE PENNE PHONE 
PHONY: SLATE CRONY PHONY 
PHOTO: SLATE MIRTH PHOTO 
PIANO: SLATE CRACK AGAIN PIANO 
PICKY: SLATE CRONY MUCKY PICKY 
PIECE: SLATE PRICE PIECE 
PIETY: SLATE PETTY PIETY 
PIGGY: SLATE CRONY DUMPY PIGGY 
PILOT: SLATE BUILT LIMIT PILOT 
PINCH: SLATE CRONY PUNCH PINCH 
PINEY: SLATE FEVER BONEY PINEY 
PINKY: SLATE CRONY PINKY 
PINTO: SLATE MIRTH DITTY PINTO 
PIPER: SLATE FEVER CIDER RIPER PIPER 
PIQUE: SLATE PRICE PIQUE 
PITCH: SLATE TIGHT DITCH PITCH 
PITHY: SLATE TIGHT PITHY 
PIVOT: SLATE TIGHT PIVOT 
PIXEL: SLATE LEVEL BOWEL EXPEL PIXEL 
PIXIE: SLATE PRICE PIQUE PIXIE 
PIZZA: SLATE MARRY APING PIZZA 
PLACE: SLATE BLARE FLAME GLADE PLANE PLACE 
PLAID: SLATE CLANK PLAID 
PLAIN: SLATE CLANK PLAIN 
PLAIT: SLATE PLANT PLAIT 
PLANE: SLATE BLARE FLAME GLADE PLANE 
PLANK: SLATE CLANK FLANK PLANK 
PLANT: SLATE PLANT 
PLATE: SLATE PLATE 
PLAZA: SLATE CLANK PLAID PLAZA 
PLEAD: SLATE CLEAN GLEAM BLEAK PLEAD 
PLEAT: SLATE CLEAT BLEAT PLEAT 
PLIED: SLATE ELDER BLEED PLIED 
PLIER: SLATE ELDER FLIER PLIER 
PLUCK: SLATE FLUNK CLUCK PLUCK 
PLUMB: SLATE FLUNK PLUMP PLUMB 
PLUME: SLATE GLOVE ELUDE FLUME PLUME 
PLUMP: SLATE FLUNK PLUMP 
PLUNK: SLATE FLUNK PLUNK 
PLUSH: SLATE BLUSH FLUSH PLUSH 
POESY: SLATE RISER CHESS POESY 
POINT: SLATE TIGHT PRINT POINT 
POISE: SLATE NOOSE HOUSE POSSE POISE 
POKER: SLATE FEVER CIDER POWER POKER 
POLAR: SLATE CANAL MOLAR POLAR 
POLKA: SLATE CANAL VILLA POLKA 
POLYP: SLATE GOLLY POLYP 
POOCH: SLATE CRONY POOCH 
POPPY: SLATE CRONY DOWDY HOBBY FOGGY POPPY 
PORCH: SLATE CRONY MICRO PORCH 
POSER: SLATE RISER POSER 
POSIT: SLATE FOIST POSIT 
POSSE: SLATE NOOSE HOUSE POSSE 
POUCH: SLATE CRONY POUCH 
POUND: SLATE CRONY POUND 
POUTY: SLATE MIRTH PUTTY POUTY 
POWER: SLATE FEVER CIDER POWER 
PRANK: SLATE CRACK DRANK PRANK 
PRAWN: SLATE CRACK BRAIN DRAWN PRAWN 
PREEN: SLATE FEVER CREED PREEN 
PRESS: SLATE RISER PRESS 
PRICE: SLATE PRICE 
PRICK: SLATE CRONY PRICK 
PRIDE: SLATE PRICE PRIDE 
PRIED: SLATE FEVER CREED PRIED 
PRIME: SLATE PRICE PRIDE PRIME 
PRIMO: SLATE CRONY PRIOR PRIMO 
PRINT: SLATE TIGHT PRINT 
PRIOR: SLATE CRONY PRIOR 
PRISM: SLATE MISSY PRISM 
PRIVY: SLATE CRONY GRIMY PRIVY 
PRIZE: SLATE PRICE PRIDE PRIME PRIZE 
PROBE: SLATE PRICE PRONE PROVE PROBE 
PRONE: SLATE PRICE PRONE 
PRONG: SLATE CRONY PRONG 
PROOF: SLATE CRONY BROOD GROOM PROOF 
PROSE: SLATE NOOSE CHOSE PROSE 
PROUD: SLATE CRONY BROOD PROUD 
PROVE: SLATE PRICE PRONE PROVE 
PROWL: SLATE GOLLY BROIL DROOL PROWL 
PROXY: SLATE CRONY PROXY 
PRUDE: SLATE PRICE PRONE PRUDE 
PRUNE: SLATE PRICE PRONE PRUNE 
PSALM: SLATE PSALM 
PUBIC: SLATE CRONY QUICK PUBIC 
PUDGY: SLATE CRONY DUMPY PUDGY 
PUFFY: SLATE CRONY DUMPY PUFFY 
PULPY: SLATE GOLLY BULKY PULPY 
PULSE: SLATE LOOSE PULSE 
PUNCH: SLATE CRONY PUNCH 
PUPAL: SLATE CANAL MORAL PUPAL 
PUPIL: SLATE GOLLY LURID PUPIL 
PUPPY: SLATE CRONY DUMPY PUPPY 
PUREE: SLATE PRICE PURGE PUREE 
PURER: SLATE FEVER CIDER POWER PURER 
PURGE: SLATE PRICE PURGE 
PURSE: SLATE NOOSE PURSE 
PUSHY: SLATE MISSY BUSHY PUSHY 
PUTTY: SLATE MIRTH PUTTY 
PYGMY: SLATE CRONY DUMPY PYGMY 
QUACK: SLATE CRACK WHACK QUACK 
QUAIL: SLATE FRAIL QUAIL 
QUAKE: SLATE GRAVE AWAKE QUAKE 
QUALM: SLATE FRAIL KOALA QUALM 
QUARK: SLATE CRACK QUARK 
QUART: SLATE TRAIT CHART APART QUART 
QUASH: SLATE CRASH QUASH 
QUASI: SLATE CRASH AMASS QUASI 
QUEEN: SLATE FEVER BONEY KNEED QUEEN 
QUEER: SLATE FEVER CIDER POWER BUYER QUEER 
QUELL: SLATE LEVEL DWELL QUELL 
QUERY: SLATE FEVER CREDO QUERY 
QUEST: SLATE CREST GUEST QUEST 
QUEUE: SLATE PRICE FUDGE QUEUE 
QUICK: SLATE CRONY QUICK 
QUIET: SLATE TENET COVET QUIET 
QUILL: SLATE GOLLY CHILL DRILL QUILL 
QUILT: SLATE BUILT GUILT QUILT 
QUIRK: SLATE CRONY QUIRK 
QUITE: SLATE WRITE QUITE 
QUOTA: SLATE CATTY JUNTA QUOTA 
QUOTE: SLATE WRITE QUOTE 
QUOTH: SLATE MIRTH BOOTH QUOTH 
RABBI: SLATE MARRY RADAR RABBI 
RABID: SLATE MARRY RADAR RABID 
RACER: SLATE RACER 
RADAR: SLATE MARRY RADAR 
RADII: SLATE MARRY RADAR RADII 
RADIO: SLATE MARRY RADAR RADII RADIO 
RAINY: SLATE MARRY RANDY RAINY 
RAISE: SLATE PAUSE RAISE 
RAJAH: SLATE MARRY RADAR RAJAH 
RALLY: SLATE CANAL RALLY 
RALPH: SLATE CANAL RALLY RALPH 
RAMEN: SLATE RACER RAMEN 
RANCH: SLATE MARRY RADAR RABBI RANCH 
RANDY: SLATE MARRY RANDY 
RANGE: SLATE MAUVE BARGE RANGE 
RAPID: SLATE MARRY RADAR RABID RAPID 
RARER: SLATE RACER RARER 
RASPY: SLATE GASSY RASPY 
RATIO: SLATE TAUNT PATCH RATIO 
RATTY: SLATE CATTY PATTY FATTY BATTY TATTY RATTY 
RAVEN: SLATE RACER RAMEN RAVEN 
RAYON: SLATE MARRY RAYON 
RAZOR: SLATE MARRY RADAR RAZOR 
REACH: SLATE BEADY REACH 
REACT: SLATE REACT 
READY: SLATE BEADY READY 
REALM: SLATE LEAKY PEARL REALM 
REARM: SLATE BEADY REACH REARM 
REBAR: SLATE RACER REBAR 
REBEL: SLATE LEVEL REPEL REBEL 
REBUS: SLATE RISER REBUS 
REBUT: SLATE TENET DEBIT REBUT 
RECAP: SLATE RACER RECAP 
RECUR: SLATE FEVER DECOR RECUR 
RECUT: SLATE TENET DEBIT RECUT 
REEDY: SLATE FEVER MERRY REEDY 
REFER: SLATE FEVER DEFER REFER 
REFIT: SLATE TENET DEBIT REFIT 
REGAL: SLATE LEGAL REGAL 
REHAB: SLATE RACER REPAY REHAB 
REIGN: SLATE FEVER MERRY REIGN 
RELAX: SLATE LEGAL RELAY RELAX 
RELAY: SLATE LEGAL RELAY 
RELIC: SLATE LEVEL BELLY FELON RELIC 
REMIT: SLATE TENET DEBIT REFIT REMIT 
RENAL: SLATE LEGAL PEDAL FECAL RENAL 
RENEW: SLATE FEVER RENEW 
REPAY: SLATE RACER REPAY 
REPEL: SLATE LEVEL REPEL 
REPLY: SLATE LEVEL BELLY REPLY 
RERUN: SLATE FEVER MERRY RERUN 
RESET: SLATE CREST RESET 
RESIN: SLATE RISER RESIN 
RETCH: SLATE TENET RETRO RETCH 
RETRO: SLATE TENET RETRO 
RETRY: SLATE TENET RETRO RETRY 
REUSE: SLATE NOOSE PURSE REUSE 
REVEL: SLATE LEVEL REVEL 
REVUE: SLATE PRICE GORGE RHYME REVUE 
RHINO: SLATE CRONY ROUND RHINO 
RHYME: SLATE PRICE GORGE RHYME 
RIDER: SLATE FEVER CIDER RIDER 
RIDGE: SLATE PRICE DIRGE RIDGE 
RIFLE: SLATE BELLE WHILE RIFLE 
RIGHT: SLATE TIGHT MIGHT FIGHT RIGHT 
RIGID: SLATE CRONY QUIRK RIGID 
RIGOR: SLATE CRONY FUROR RIGOR 
RINSE: SLATE NOOSE DENSE RINSE 
RIPEN: SLATE FEVER CREED RIPEN 
RIPER: SLATE FEVER CIDER RIPER 
RISEN: SLATE RISER RISEN 
RISER: SLATE RISER 
RISKY: SLATE MISSY FISHY RISKY 
RIVAL: SLATE CANAL MORAL RIVAL 
RIVER: SLATE FEVER ROVER RIVER 
RIVET: SLATE TENET COVET DUVET RIVET 
ROACH: SLATE CRACK ROACH 
ROAST: SLATE TOAST COAST BOAST ROAST 
ROBIN: SLATE CRONY DONOR MOURN ROBIN 
ROBOT: SLATE TIGHT COUNT ROBOT 
ROCKY: SLATE CRONY ROCKY 
RODEO: SLATE FEVER CREED RODEO 
ROGER: SLATE FEVER CIDER POWER BOXER JOKER HOMER GONER ROGER 
ROGUE: SLATE PRICE GORGE ROGUE 
ROOMY: SLATE CRONY ROOMY 
ROOST: SLATE FOIST BOOST ROOST 
ROTOR: SLATE TIGHT MOTOR ROTOR 
ROUGE: SLATE PRICE GORGE ROUGE 
ROUGH: SLATE CRONY FUROR ROUGH 
ROUND: SLATE CRONY ROUND 
ROUSE: SLATE NOOSE HOUSE ROUSE 
ROUTE: SLATE WRITE ROUTE 
ROVER: SLATE FEVER ROVER 
ROWDY: SLATE CRONY WORRY ROWDY 
ROWER: SLATE FEVER CIDER POWER ROWER 
ROYAL: SLATE CANAL MORAL ROYAL 
RUDDY: SLATE CRONY FURRY RUDDY 
RUDER: SLATE FEVER CIDER UDDER RUDER 
RUGBY: SLATE CRONY FURRY RUDDY RUGBY 
RULER: SLATE LEVEL FILER RULER 
RUMBA: SLATE MARRY ARMOR RUMBA 
RUMOR: SLATE CRONY FUROR RUMOR 
RUPEE: SLATE PRICE RUPEE 
RURAL: SLATE CANAL MORAL RURAL 
RUSTY: SLATE GUSTY DUSTY MUSTY RUSTY 
SADLY: SLATE SALLY SADLY 
SAFER: SLATE SPEAR SANER SAFER 
SAINT: SLATE STRAY SAINT 
SALAD: SLATE SALLY SALAD 
SALLY: SLATE SALLY 
SALON: SLATE SALLY SALAD SALON 
SALSA: SLATE SALLY SALAD SALON SALSA 
SALTY: SLATE SALTY 
SALVE: SLATE SALVE 
SALVO: SLATE SALLY SALAD SALON SALVO 
SANDY: SLATE SAUCY SAVOY SANDY 
SANER: SLATE SPEAR SANER 
SAPPY: SLATE SAUCY SAVOY SANDY SASSY SAPPY 
SASSY: SLATE SAUCY SAVOY SANDY SASSY 
SATIN: SLATE STRAY SAINT SATIN 
SATYR: SLATE STRAY SATYR 
SAUCE: SLATE SAUCE 
SAUCY: SLATE SAUCY 
SAUNA: SLATE SAUCY SAUNA 
SAUTE: SLATE SAUTE 
SAVOR: SLATE SAUCY SAVOR 
SAVOY: SLATE SAUCY SAVOY 
SAVVY: SLATE SAUCY SAVOY SAVVY 
SCALD: SLATE SHALL SCALY SCALD 
SCALE: SLATE SHALE SCALE 
SCALP: SLATE SHALL SCALY SCALD SCALP 
SCALY: SLATE SHALL SCALY 
SCAMP: SLATE SHARK SWAMP SCAMP 
SCANT: SLATE START SCANT 
SCARE: SLATE SHARE SPARE SNARE SCARE 
SCARF: SLATE SHARK SCARY SCARF 
SCARY: SLATE SHARK SCARY 
SCENE: SLATE SPORE SINGE SCENE 
SCENT: SLATE SWEET SPENT SCENT 
SCION: SLATE SHOOK SCION 
SCOFF: SLATE SHOOK SCORN SCOFF 
SCOLD: SLATE SPILL SULLY SCOLD 
SCONE: SLATE SPORE SHONE SCONE 
SCOOP: SLATE SHOOK SWOOP SCOOP 
SCOPE: SLATE SPORE SCOPE 
SCORE: SLATE SPORE SHORE SCORE 
SCORN: SLATE SHOOK SCORN 
SCOUR: SLATE SHOOK SCORN SCOUR 
SCOUT: SLATE STOUT SHOUT SPOUT SNOUT SCOUT 
SCOWL: SLATE SPILL SCOWL 
SCRAM: SLATE SAUCY SCRAP SCRAM 
SCRAP: SLATE SAUCY SCRAP 
SCREE: SLATE SPORE SERVE SCREE 
SCREW: SLATE SHEER SIREN SCREW 
SCRUB: SLATE SHOOK SPINY SCRUB 
SCRUM: SLATE SHOOK SPINY SCRUB SCRUM 
SCUBA: SLATE SAUCY SCUBA 
SEDAN: SLATE SPEAR SEDAN 
SEEDY: SLATE SHEER SPEND SEEDY 
SEGUE: SLATE SPORE SINGE SEGUE 
SEIZE: SLATE SPORE SINGE SEIZE 
SEMEN: SLATE SHEER SEVEN SEMEN 
SENSE: SLATE SPORE SINGE SENSE 
SEPIA: SLATE SPEAR SEPIA 
SERIF: SLATE SHEER SERIF 
SERUM: SLATE SHEER SERIF SERUM 
SERVE: SLATE SPORE SERVE 
SETUP: SLATE SWEET SETUP 
SEVEN: SLATE SHEER SEVEN 
SEVER: SLATE SHEER SEWER SEVER 
SEWER: SLATE SHEER SEWER 
SHACK: SLATE SHARK SHACK 
SHADE: SLATE SHARE SHADE 
SHADY: SLATE SHARK SHADY 
SHAFT: SLATE START SCANT SHAFT 
SHAKE: SLATE SHARE SHADE SHAKE 
SHAKY: SLATE SHARK SHAKY 
SHALE: SLATE SHALE 
SHALL: SLATE SHALL 
SHALT: SLATE STALL SHALT 
SHAME: SLATE SHARE SHADE SHAKE SHAVE SHAME 
SHANK: SLATE SHARK SHACK SHANK 
SHAPE: SLATE SHARE SHADE SHAKE SHAVE SHAME SHAPE 
SHARD: SLATE SHARK SHARP SHARD 
SHARE: SLATE SHARE 
SHARK: SLATE SHARK 
SHARP: SLATE SHARK SHARP 
SHAVE: SLATE SHARE SHADE SHAKE SHAVE 
SHAWL: SLATE SHALL SHAWL 
SHEAR: SLATE SPEAR SHEAR 
SHEEN: SLATE SHEER SHEEN 
SHEEP: SLATE SHEER SHEEN SHEEP 
SHEER: SLATE SHEER 
SHEET: SLATE SWEET SHEET 
SHEIK: SLATE SHEER SHEIK 
SHELF: SLATE SHELL SHELF 
SHELL: SLATE SHELL 
SHIED: SLATE SHEER SHIED 
SHIFT: SLATE STOUT SHIRT SHIFT 
SHINE: SLATE SPORE SINGE SHINE 
SHINY: SLATE SHOOK SHRUG SHINY 
SHIRE: SLATE SPORE SHIRE 
SHIRK: SLATE SHOOK SHIRK 
SHIRT: SLATE STOUT SHIRT 
SHOAL: SLATE SALLY SHOAL 
SHOCK: SLATE SHOOK SHOCK 
SHONE: SLATE SPORE SHONE 
SHOOK: SLATE SHOOK 
SHOOT: SLATE STOUT SHORT SHOOT 
SHORE: SLATE SPORE SHORE 
SHORN: SLATE SHOOK SHOWN SHORN 
SHORT: SLATE STOUT SHORT 
SHOUT: SLATE STOUT SHOUT 
SHOVE: SLATE SPORE SHONE SHOVE 
SHOWN: SLATE SHOOK SHOWN 
SHOWY: SLATE SHOOK SHOWN SHOWY 
SHREW: SLATE SHEER SHREW 
SHRUB: SLATE SHOOK SHRUG SHRUB 
SHRUG: SLATE SHOOK SHRUG 
SHUCK: SLATE SHOOK SHIRK SHUCK 
SHUNT: SLATE STOUT SHUNT 
SHUSH: SLATE SHOOK SHRUG SHUSH 
SHYLY: SLATE SPILL SULLY SHYLY 
SIEGE: SLATE SPORE SINGE SIEGE 
SIEVE: SLATE SPORE SINGE SIEVE 
SIGHT: SLATE STOUT SHIRT SIGHT 
SIGMA: SLATE SAUCY SONAR SIGMA 
SILKY: SLATE SPILL SILKY 
SILLY: SLATE SPILL SILLY 
SINCE: SLATE SPORE SINGE SINCE 
SINEW: SLATE SHEER SEVEN SINEW 
SINGE: SLATE SPORE SINGE 
SIREN: SLATE SHEER SIREN 
SISSY: SLATE SHOOK SPINY SISSY 
SIXTH: SLATE SOOTH SIXTH 
SIXTY: SLATE SOOTH SIXTY 
SKATE: SLATE STATE SKATE 
SKIER: SLATE SHEER SEWER SURER SOBER SKIER 
SKIFF: SLATE SHOOK SKIFF 
SKILL: SLATE SPILL SKILL 
SKIMP: SLATE SHOOK SKIFF SKIMP 
SKIRT: SLATE STOUT SHIRT SKIRT 
SKULK: SLATE SPILL SULLY SKULK 
SKULL: SLATE SPILL SKULL 
SKUNK: SLATE SHOOK SPUNK SKUNK 
SLACK: SLATE SLASH SLAIN SLACK 
SLAIN: SLATE SLASH SLAIN 
SLANG: SLATE SLASH SLAIN SLANG 
SLANT: SLATE SLANT 
SLASH: SLATE SLASH 
SLATE: SLATE 
SLAVE: SLATE SLAVE 
SLEEK: SLATE SLEEK 
SLEEP: SLATE SLEEK SLEEP 
SLEET: SLATE SLEET 
SLEPT: SLATE SLEET SLEPT 
SLICE: SLATE SLICE 
SLICK: SLATE SLUNK SLICK 
SLIDE: SLATE SLICE SLIDE 
SLIME: SLATE SLICE SLIDE SLIME 
SLIMY: SLATE SLUNK SLIMY 
SLING: SLATE SLUNK SLING 
SLINK: SLATE SLUNK SLINK 
SLOOP: SLATE SLUNK SLIMY SLOSH SLOOP 
SLOPE: SLATE SLICE SLOPE 
SLOSH: SLATE SLUNK SLIMY SLOSH 
SLOTH: SLATE SLOTH 
SLUMP: SLATE SLUNK SLUMP 
SLUNG: SLATE SLUNK SLUNG 
SLUNK: SLATE SLUNK 
SLURP: SLATE SLUNK SLUMP SLURP 
SLUSH: SLATE SLUNK SLUMP SLUSH 
SLYLY: SLATE SLUNK SLIMY SLYLY 
SMACK: SLATE SHARK SMACK 
SMALL: SLATE SHALL SMALL 
SMART: SLATE START SMART 
SMASH: SLATE SHARK SWASH SMASH 
SMEAR: SLATE SPEAR SHEAR SWEAR SMEAR 
SMELL: SLATE SHELL SPELL SWELL SMELL 
SMELT: SLATE SPELT SMELT 
SMILE: SLATE SMILE 
SMIRK: SLATE SHOOK SPUNK SMIRK 
SMITE: SLATE SMITE 
SMITH: SLATE SOOTH SIXTH SMITH 
SMOCK: SLATE SHOOK SMOCK 
SMOKE: SLATE SPORE SHONE SMOKE 
SMOKY: SLATE SHOOK SMOKY 
SMOTE: SLATE SMITE SMOTE 
SNACK: SLATE SHARK SMACK SNACK 
SNAIL: SLATE SHALL SNAIL 
SNAKE: SLATE SHARE SPADE SNAKE 
SNAKY: SLATE SHARK SNAKY 
SNARE: SLATE SHARE SPARE SNARE 
SNARL: SLATE SHALL SNAIL SNARL 
SNEAK: SLATE SPEAR SNEAK 
SNEER: SLATE SHEER SNEER 
SNIDE: SLATE SPORE SINGE SHINE SNIDE 
SNIFF: SLATE SHOOK SPINY SNIFF 
SNIPE: SLATE SPORE SNIPE 
SNOOP: SLATE SHOOK SWOOP SCOOP SNOOP 
SNORE: SLATE SPORE SHORE SCORE SNORE 
SNORT: SLATE STOUT SHORT SPORT SNORT 
SNOUT: SLATE STOUT SHOUT SPOUT SNOUT 
SNOWY: SLATE SHOOK SCORN SNOWY 
SNUCK: SLATE SHOOK SPUNK SNUCK 
SNUFF: SLATE SHOOK SPINY SNUFF 
SOAPY: SLATE SHARK SWAMP SOAPY 
SOBER: SLATE SHEER SEWER SURER SOBER 
SOGGY: SLATE SHOOK SORRY SOGGY 
SOLAR: SLATE SALLY SOLAR 
SOLID: SLATE SPILL SILKY SOLID 
SOLVE: SLATE SMILE SOLVE 
SONAR: SLATE SAUCY SONAR 
SONIC: SLATE SHOOK SORRY SOUND SONIC 
SOOTH: SLATE SOOTH 
SOOTY: SLATE SOOTH SOOTY 
SORRY: SLATE SHOOK SORRY 
SOUND: SLATE SHOOK SORRY SOUND 
SOUTH: SLATE SOOTH SOUTH 
SOWER: SLATE SHEER SEWER SOWER 
SPACE: SLATE SHARE SPADE SPACE 
SPADE: SLATE SHARE SPADE 
SPANK: SLATE SHARK SMACK SPANK 
SPARE: SLATE SHARE SPARE 
SPARK: SLATE SHARK SPARK 
SPASM: SLATE SHARK SWAMP SPASM 
SPAWN: SLATE SHARK SWAMP SPAWN 
SPEAK: SLATE SPEAR SPEAK 
SPEAR: SLATE SPEAR 
SPECK: SLATE SHEER SPEND SPECK 
SPEED: SLATE SHEER SPEED 
SPELL: SLATE SHELL SPELL 
SPELT: SLATE SPELT 
SPEND: SLATE SHEER SPEND 
SPENT: SLATE SWEET SPENT 
SPERM: SLATE SHEER SPERM 
SPICE: SLATE SPORE SPINE SPIKE SPICE 
SPICY: SLATE SHOOK SPINY SPICY 
SPIED: SLATE SHEER SEVEN SPIED 
SPIEL: SLATE SHELL SPIEL 
SPIKE: SLATE SPORE SPINE SPIKE 
SPIKY: SLATE SHOOK SKIFF SPIKY 
SPILL: SLATE SPILL 
SPILT: SLATE STILT SPILT 
SPINE: SLATE SPORE SPINE 
SPINY: SLATE SHOOK SPINY 
SPIRE: SLATE SPORE SPIRE 
SPITE: SLATE SMITE SUITE SPITE 
SPLAT: SLATE SPLAT 
SPLIT: SLATE STILT SPLIT 
SPOIL: SLATE SPILL SPOIL 
SPOKE: SLATE SPORE SPOKE 
SPOOF: SLATE SHOOK SWOOP SPOON SPOOF 
SPOOK: SLATE SHOOK SPOOK 
SPOOL: SLATE SPILL SPOOL 
SPOON: SLATE SHOOK SWOOP SPOON 
SPORE: SLATE SPORE 
SPORT: SLATE STOUT SHORT SPORT 
SPOUT: SLATE STOUT SHOUT SPOUT 
SPRAY: SLATE SAUCY SPRAY 
SPREE: SLATE SPORE SPREE 
SPRIG: SLATE SHOOK SPINY SPRIG 
SPUNK: SLATE SHOOK SPUNK 
SPURN: SLATE SHOOK SPINY SPURN 
SPURT: SLATE STOUT SHUNT SPURT 
SQUAD: SLATE SAUCY SQUAD 
SQUAT: SLATE STRAY SQUAT 
SQUIB: SLATE SHOOK SPINY SQUIB 
STACK: SLATE START STANK STACK 
STAFF: SLATE START STANK STAID STAFF 
STAGE: SLATE STARE STAGE 
STAID: SLATE START STANK STAID 
STAIN: SLATE START STANK STAIN 
STAIR: SLATE START STAIR 
STAKE: SLATE STARE STAGE STAKE 
STALE: SLATE STALE 
STALK: SLATE STALL STALK 
STALL: SLATE STALL 
STAMP: SLATE START STANK STAID STAFF STASH STAMP 
STAND: SLATE START STANK STAND 
STANK: SLATE START STANK 
STARE: SLATE STARE 
STARK: SLATE START STARK 
START: SLATE START 
STASH: SLATE START STANK STAID STAFF STASH 
STATE: SLATE STATE 
STAVE: SLATE STARE STAGE STAKE STAVE 
STEAD: SLATE STEAD 
STEAK: SLATE STEAD STEAK 
STEAL: SLATE STEAL 
STEAM: SLATE STEAD STEAK STEAM 
STEED: SLATE SWEET STEEP STEER STEED 
STEEL: SLATE SPELT STEEL 
STEEP: SLATE SWEET STEEP 
STEER: SLATE SWEET STEEP STEER 
STEIN: SLATE SWEET STEIN 
STERN: SLATE SWEET STEIN STERN 
STICK: SLATE STOUT STINK STICK 
STIFF: SLATE STOUT STINK STIFF 
STILL: SLATE STILT STILL 
STILT: SLATE STILT 
STING: SLATE STOUT STINK STING 
STINK: SLATE STOUT STINK 
STINT: SLATE STOUT STINT 
STOCK: SLATE STOUT STORK STOCK 
STOIC: SLATE STOUT STORK STOOP STONY STOIC 
STOKE: SLATE STONE STORE STOKE 
STOLE: SLATE STOLE 
STOMP: SLATE STOUT STORK STOOP STOMP 
STONE: SLATE STONE 
STONY: SLATE STOUT STORK STOOP STONY 
STOOD: SLATE STOUT STORK STOOP STOOD 
STOOL: SLATE STILT STOOL 
STOOP: SLATE STOUT STORK STOOP 
STORE: SLATE STONE STORE 
STORK: SLATE STOUT STORK 
STORM: SLATE STOUT STORK STORY STORM 
STORY: SLATE STOUT STORK STORY 
STOUT: SLATE STOUT 
STOVE: SLATE STONE STORE STOKE STOVE 
STRAP: SLATE STRAY STRAP 
STRAW: SLATE STRAY STRAP STRAW 
STRAY: SLATE STRAY 
STRIP: SLATE STOUT STINK STRIP 
STRUT: SLATE STOUT STRUT 
STUCK: SLATE STOUT STUNK STUCK 
STUDY: SLATE STOUT STUNK STUMP STUFF STUDY 
STUFF: SLATE STOUT STUNK STUMP STUFF 
STUMP: SLATE STOUT STUNK STUMP 
STUNG: SLATE STOUT STUNK STUNG 
STUNK: SLATE STOUT STUNK 
STUNT: SLATE STOUT STUNT 
STYLE: SLATE STOLE STYLE 
SUAVE: SLATE SHARE SPADE SNAKE SUAVE 
SUGAR: SLATE SAUCY SUGAR 
SUING: SLATE SHOOK SPINY SWING SUING 
SUITE: SLATE SMITE SUITE 
SULKY: SLATE SPILL SULKY 
SULLY: SLATE SPILL SULLY 
SUMAC: SLATE SAUCY SUMAC 
SUNNY: SLATE SHOOK SPINY SUNNY 
SUPER: SLATE SHEER SEWER SURER SUPER 
SURER: SLATE SHEER SEWER SURER 
SURGE: SLATE SPORE SERVE SCREE SURGE 
SURLY: SLATE SPILL SULLY SURLY 
SUSHI: SLATE SHOOK SWISH SUSHI 
SWAMI: SLATE SHARK SWAMP SWAMI 
SWAMP: SLATE SHARK SWAMP 
SWARM: SLATE SHARK SCARY SWARM 
SWASH: SLATE SHARK SWASH 
SWATH: SLATE SWATH 
SWEAR: SLATE SPEAR SHEAR SWEAR 
SWEAT: SLATE STEAD SWEAT 
SWEEP: SLATE SHEER SPEED SWEEP 
SWEET: SLATE SWEET 
SWELL: SLATE SHELL SPELL SWELL 
SWEPT: SLATE SWEET SWEPT 
SWIFT: SLATE STOUT SHIRT SWIFT 
SWILL: SLATE SPILL SKILL SWILL 
SWINE: SLATE SPORE SINGE SHINE SWINE 
SWING: SLATE SHOOK SPINY SWING 
SWIRL: SLATE SPILL SWIRL 
SWISH: SLATE SHOOK SWISH 
SWOON: SLATE SHOOK SWOOP SWOON 
SWOOP: SLATE SHOOK SWOOP 
SWORD: SLATE SHOOK SCORN SWORD 
SWORE: SLATE SPORE SHORE SCORE SNORE SWORE 
SWORN: SLATE SHOOK SCORN SWORN 
SWUNG: SLATE SHOOK SPINY SWUNG 
SYNOD: SLATE SHOOK SCION SYNOD 
SYRUP: SLATE SHOOK SPINY SYRUP 
TABBY: SLATE TAUNT TABBY 
TABLE: SLATE TABLE 
TABOO: SLATE TAUNT TABBY TABOO 
TACIT: SLATE TAUNT TACIT 
TACKY: SLATE TAUNT TABBY TARDY TACKY 
TAFFY: SLATE TAUNT TABBY TARDY TACKY TAFFY 
TAINT: SLATE TAUNT TAINT 
TAKEN: SLATE CATER TAKEN 
TAKER: SLATE CATER TAKER 
TALLY: SLATE FATAL TALLY 
TALON: SLATE FATAL TALLY TALON 
TAMER: SLATE CATER TAKER TAMER 
TANGO: SLATE TAUNT TANGY TANGO 
TANGY: SLATE TAUNT TANGY 
TAPER: SLATE CATER TAKER TAMER TAPER 
TAPIR: SLATE TAUNT TABBY TAPIR 
TARDY: SLATE TAUNT TABBY TARDY 
TAROT: SLATE TAUNT TACIT TAROT 
TASTE: SLATE CASTE BASTE TASTE 
TASTY: SLATE PASTY TASTY 
TATTY: SLATE CATTY PATTY FATTY BATTY TATTY 
TAUNT: SLATE TAUNT 
TAWNY: SLATE TAUNT TAWNY 
TEACH: SLATE REACT TEACH 
TEARY: SLATE REACT TEARY 
TEASE: SLATE TEASE 
TEDDY: SLATE TENET TEPID TEDDY 
TEETH: SLATE PETTY TEETH 
TEMPO: SLATE TENET TEPID TEMPO 
TENET: SLATE TENET 
TENOR: SLATE TENET TENOR 
TENSE: SLATE TERSE TENSE 
TENTH: SLATE PETTY TEETH TENTH 
TEPEE: SLATE TRICE THEME TEPEE 
TEPID: SLATE TENET TEPID 
TERRA: SLATE CATER TREAT TERRA 
TERSE: SLATE TERSE 
TESTY: SLATE TESTY 
THANK: SLATE TRAIT THANK 
THEFT: SLATE TENET THEFT 
THEIR: SLATE TENET THEIR 
THEME: SLATE TRICE THEME 
THERE: SLATE TRICE THREE THERE 
THESE: SLATE TERSE THOSE THESE 
THETA: SLATE EARTH THETA 
THICK: SLATE TIGHT THINK THICK 
THIEF: SLATE TENET TIMER THIEF 
THIGH: SLATE TIGHT THING THIGH 
THING: SLATE TIGHT THING 
THINK: SLATE TIGHT THINK 
THIRD: SLATE TIGHT THINK THIRD 
THONG: SLATE TIGHT TOUGH THONG 
THORN: SLATE TIGHT THROB THORN 
THOSE: SLATE TERSE THOSE 
THREE: SLATE TRICE THREE 
THREW: SLATE TENET TIMER THREW 
THROB: SLATE TIGHT THROB 
THROW: SLATE TIGHT THROB THROW 
THRUM: SLATE TIGHT THROB THRUM 
THUMB: SLATE TIGHT THROB THUMB 
THUMP: SLATE TIGHT THROB THUMP 
THYME: SLATE TRICE THEME THYME 
TIARA: SLATE TRAIT TIARA 
TIBIA: SLATE TAUNT TODAY TIBIA 
TIDAL: SLATE FATAL TONAL TIDAL 
TIGER: SLATE TENET TIMER TIGER 
TIGHT: SLATE TIGHT 
TILDE: SLATE TITLE TILDE 
TIMER: SLATE TENET TIMER 
TIMID: SLATE TIGHT TIMID 
TIPSY: SLATE FOIST TIPSY 
TITAN: SLATE TAUNT TITAN 
TITHE: SLATE TRICE TITHE 
TITLE: SLATE TITLE 
TOAST: SLATE TOAST 
TODAY: SLATE TAUNT TODAY 
TODDY: SLATE TIGHT TRUCK TODDY 
TOKEN: SLATE TENET TOKEN 
TONAL: SLATE FATAL TONAL 
TONGA: SLATE TAUNT TITAN TONGA 
TONIC: SLATE TIGHT TONIC 
TOOTH: SLATE MIRTH BOOTH TOOTH 
TOPAZ: SLATE TAUNT TODAY TOPAZ 
TOPIC: SLATE TIGHT TONIC TOXIC TOPIC 
TORCH: SLATE TIGHT THROB TORCH 
TORSO: SLATE FOIST TORSO 
TORUS: SLATE FOIST TORUS 
TOTAL: SLATE FATAL TOTAL 
TOTEM: SLATE TENET TIMER TOTEM 
TOUCH: SLATE TIGHT THROB TOUCH 
TOUGH: SLATE TIGHT TOUGH 
TOWEL: SLATE MOTEL TOWEL 
TOWER: SLATE TENET TIMER TRUER TOWER 
TOXIC: SLATE TIGHT TONIC TOXIC 
TOXIN: SLATE TIGHT TONIC TOXIN 
TRACE: SLATE TRACE 
TRACK: SLATE TRAIT TRACK 
TRACT: SLATE TRAIT TRACT 
TRADE: SLATE TRACE TRADE 
TRAIL: SLATE TRAIL 
TRAIN: SLATE TRAIT TRAIN 
TRAIT: SLATE TRAIT 
TRAMP: SLATE TRAIT TRACK TRAMP 
TRASH: SLATE TOAST TRASH 
TRAWL: SLATE TRAIL TRAWL 
TREAD: SLATE CATER TREAT TREAD 
TREAT: SLATE CATER TREAT 
TREND: SLATE TENET TREND 
TRIAD: SLATE TAUNT TODAY TRIAD 
TRIAL: SLATE FATAL TONAL TIDAL TRIAL 
TRIBE: SLATE TRICE TRIPE TRIBE 
TRICE: SLATE TRICE 
TRICK: SLATE TIGHT TONIC TRICK 
TRIED: SLATE TENET TIMER TRIED 
TRIPE: SLATE TRICE TRIPE 
TRITE: SLATE WRITE TRITE 
TROLL: SLATE BUILT TROLL 
TROOP: SLATE TIGHT TRUCK TROOP 
TROPE: SLATE TRICE TROPE 
TROUT: SLATE TIGHT TROUT 
TROVE: SLATE TRICE TROPE TROVE 
TRUCE: SLATE TRICE TRUCE 
TRUCK: SLATE TIGHT TRUCK 
TRUER: SLATE TENET TIMER TRUER 
TRULY: SLATE BUILT TRULY 
TRUMP: SLATE TIGHT TRUCK TRUMP 
TRUNK: SLATE TIGHT TRUCK TRUNK 
TRUSS: SLATE FOIST TRUSS 
TRUST: SLATE FOIST TRUST 
TRUTH: SLATE MIRTH FROTH TRUTH 
TRYST: SLATE FOIST TRUST TRYST 
TUBAL: SLATE FATAL TONAL TIDAL TUBAL 
TUBER: SLATE TENET TIMER TRUER TUBER 
TULIP: SLATE BUILT TULIP 
TULLE: SLATE TITLE TULLE 
TUMOR: SLATE TIGHT TRUCK TUTOR TUMOR 
TUNIC: SLATE TIGHT TONIC TUNIC 
TURBO: SLATE TIGHT TRUCK TUTOR TURBO 
TUTOR: SLATE TIGHT TRUCK TUTOR 
TWANG: SLATE TRAIT THANK TWANG 
TWEAK: SLATE CATER WHEAT TWEAK 
TWEED: SLATE TENET TIMER TWEED 
TWEET: SLATE TENET TWEET 
TWICE: SLATE TRICE TWICE 
TWINE: SLATE TRICE TWINE 
TWIRL: SLATE BUILT TWIRL 
TWIST: SLATE FOIST WRIST TWIST 
TWIXT: SLATE TIGHT TWIXT 
TYING: SLATE TIGHT TYING 
UDDER: SLATE FEVER CIDER UDDER 
ULCER: SLATE ELDER FLIER BLUER ULCER 
ULTRA: SLATE BLOAT ULTRA 
UMBRA: SLATE MARRY UMBRA 
UNCLE: SLATE BELLE WHILE CYCLE UNCLE 
UNCUT: SLATE TIGHT COUNT UNCUT 
UNDER: SLATE FEVER CIDER UDDER UNDER 
UNDID: SLATE CRONY UNDID 
UNDUE: SLATE PRICE FUDGE UNDUE 
UNFED: SLATE FEVER CHIEF UNFED 
UNFIT: SLATE TIGHT PRINT UNFIT 
UNIFY: SLATE CRONY PINKY UNIFY 
UNION: SLATE CRONY BINGO ONION UNION 
UNITE: SLATE WRITE QUITE UNITE 
UNITY: SLATE MIRTH UNITY 
UNLIT: SLATE BUILT UNLIT 
UNMET: SLATE TENET UNMET 
UNSET: SLATE CREST UNSET 
UNTIE: SLATE TRICE UNTIE 
UNTIL: SLATE BUILT UNTIL 
UNWED: SLATE FEVER BONEY KNEED UNWED 
UNZIP: SLATE CRONY UNDID UNZIP 
UPPER: SLATE FEVER CIDER POWER HYPER UPPER 
UPSET: SLATE CREST UNSET UPSET 
URBAN: SLATE MARRY BRIAR URBAN 
URINE: SLATE PRICE BRINE URINE 
USAGE: SLATE CHASE USAGE 
USHER: SLATE RISER USHER 
USING: SLATE MISSY USING 
USUAL: SLATE BASAL USUAL 
USURP: SLATE MISSY BONUS USURP 
UTILE: SLATE TITLE UTILE 
UTTER: SLATE TENET OTTER UTTER 
VAGUE: SLATE MAUVE VAGUE 
VALET: SLATE PETAL VALET 
VALID: SLATE CANAL RALLY VALID 
VALOR: SLATE CANAL RALLY VALOR 
VALUE: SLATE CABLE VALVE VALUE 
VALVE: SLATE CABLE VALVE 
VAPID: SLATE MARRY CANON VAPID 
VAPOR: SLATE MARRY RADAR VAPOR 
VAULT: SLATE FATAL TALLY VAULT 
VAUNT: SLATE TAUNT HAUNT DAUNT GAUNT JAUNT VAUNT 
VEGAN: SLATE RACER KNEAD BEGAN VEGAN 
VENOM: SLATE FEVER VENOM 
VENUE: SLATE PRICE FUDGE VENUE 
VERGE: SLATE PRICE GORGE VERGE 
VERSE: SLATE NOOSE PURSE VERSE 
VERSO: SLATE RISER PRESS VERSO 
VERVE: SLATE PRICE GORGE VERVE 
VICAR: SLATE MARRY BRIAR CIGAR VICAR 
VIDEO: SLATE FEVER VIXEN VIDEO 
VIGIL: SLATE GOLLY VIGIL 
VIGOR: SLATE CRONY FUROR RIGOR VIGOR 
VILLA: SLATE CANAL VILLA 
VINYL: SLATE GOLLY LYNCH VINYL 
VIOLA: SLATE CANAL VILLA VIOLA 
VIPER: SLATE FEVER VIPER 
VIRAL: SLATE CANAL MORAL RURAL VIRAL 
VIRUS: SLATE MISSY FICUS VIRUS 
VISIT: SLATE FOIST VISIT 
VISOR: SLATE MISSY BISON VISOR 
VISTA: SLATE PASTY VISTA 
VITAL: SLATE FATAL TOTAL VITAL 
VIVID: SLATE CRONY HUMID VIVID 
VIXEN: SLATE FEVER VIXEN 
VOCAL: SLATE CANAL LOCAL VOCAL 
VODKA: SLATE MARRY APING COCOA VODKA 
VOGUE: SLATE PRICE FUDGE VOGUE 
VOICE: SLATE PRICE VOICE 
VOILA: SLATE CANAL VILLA VOILA 
VOMIT: SLATE TIGHT PRINT VOMIT 
VOTER: SLATE TENET OTTER VOTER 
VOUCH: SLATE CRONY POUCH VOUCH 
VOWEL: SLATE LEVEL VOWEL 
VYING: SLATE CRONY DYING VYING 
WACKY: SLATE MARRY CANDY WACKY 
WAFER: SLATE RACER WAGER WAVER WAFER 
WAGER: SLATE RACER WAGER 
WAGON: SLATE MARRY CANON WAGON 
WAIST: SLATE ARTSY WAIST 
WAIVE: SLATE MAUVE WAIVE 
WALTZ: SLATE WALTZ 
WARTY: SLATE CATTY PARTY WARTY 
WASTE: SLATE CASTE BASTE TASTE PASTE WASTE 
WATCH: SLATE TAUNT PATCH HATCH CATCH BATCH WATCH 
WATER: SLATE CATER EATER WATER 
WAVER: SLATE RACER WAGER WAVER 
WAXEN: SLATE RACER OAKEN HAVEN WAXEN 
WEARY: SLATE BEADY WEARY 
WEAVE: SLATE GRAVE WEAVE 
WEDGE: SLATE PRICE FUDGE WEDGE 
WEEDY: SLATE FEVER BEECH WEEDY 
WEIGH: SLATE FEVER BEECH WEIGH 
WEIRD: SLATE FEVER MERRY WEIRD 
WELCH: SLATE LEVEL BELLY FELON RELIC WELCH 
WELSH: SLATE LOSER WELSH 
WENCH: SLATE FEVER BEECH WENCH 
WHACK: SLATE CRACK WHACK 
WHALE: SLATE WHALE 
WHARF: SLATE CRACK BOARD WHARF 
WHEAT: SLATE CATER WHEAT 
WHEEL: SLATE LEVEL BOWEL WHEEL 
WHELP: SLATE LEVEL WIELD WHELP 
WHERE: SLATE PRICE GORGE RHYME WHERE 
WHICH: SLATE CRONY QUICK WHICH 
WHIFF: SLATE CRONY HUMID WHIFF 
WHILE: SLATE BELLE WHILE 
WHINE: SLATE PRICE OVINE WHINE 
WHINY: SLATE CRONY BUNNY WHINY 
WHIRL: SLATE GOLLY LURID WHIRL 
WHISK: SLATE MISSY BRISK WHISK 
WHITE: SLATE WRITE WHITE 
WHOLE: SLATE BELLE WHILE WHOLE 
WHOOP: SLATE CRONY WHOOP 
WHOSE: SLATE NOOSE CHOSE WHOSE 
WIDEN: SLATE FEVER BONEY KNEED WIDEN 
WIDER: SLATE FEVER CIDER RIDER WIDER 
WIDOW: SLATE CRONY BUXOM WIDOW 
WIDTH: SLATE MIRTH FIFTH NINTH WIDTH 
WIELD: SLATE LEVEL WIELD 
WIGHT: SLATE TIGHT MIGHT FIGHT RIGHT WIGHT 
WILLY: SLATE GOLLY DILLY BILLY FILLY WILLY 
WIMPY: SLATE CRONY DUMPY WIMPY 
WINCE: SLATE PRICE MINCE WINCE 
WINCH: SLATE CRONY PUNCH FINCH WINCH 
WINDY: SLATE CRONY PINKY DINGY WINDY 
WISER: SLATE RISER MISER WISER 
WISPY: SLATE MISSY FISHY RISKY WISPY 
WITCH: SLATE TIGHT DITCH PITCH HITCH WITCH 
WITTY: SLATE MIRTH DITTY BITTY WITTY 
WOKEN: SLATE FEVER BONEY WOMEN WOKEN 
WOMAN: SLATE MARRY WOMAN 
WOMEN: SLATE FEVER BONEY WOMEN 
WOODY: SLATE CRONY WOODY 
WOOER: SLATE FEVER CIDER POWER WOOER 
WOOLY: SLATE GOLLY LOWLY WOOLY 
WOOZY: SLATE CRONY WOODY WOOZY 
WORDY: SLATE CRONY WORRY WORDY 
WORLD: SLATE GOLLY WOULD WORLD 
WORRY: SLATE CRONY WORRY 
WORSE: SLATE NOOSE HOUSE POSSE WORSE 
WORST: SLATE FOIST BOOST WORST 
WORTH: SLATE MIRTH FORTH WORTH 
WOULD: SLATE GOLLY WOULD 
WOUND: SLATE CRONY POUND BOUND FOUND WOUND 
WOVEN: SLATE FEVER COVEN WOVEN 
WRACK: SLATE CRACK WRACK 
WRATH: SLATE WRATH 
WREAK: SLATE RACER BREAK WREAK 
WRECK: SLATE FEVER CREDO WRECK 
WREST: SLATE CREST WREST 
WRING: SLATE CRONY BRINK WRING 
WRIST: SLATE FOIST WRIST 
WRITE: SLATE WRITE 
WRONG: SLATE CRONY PRONG WRONG 
WROTE: SLATE WRITE WROTE 
WRUNG: SLATE CRONY BRINK WRUNG 
WRYLY: SLATE GOLLY DRYLY WRYLY 
YACHT: SLATE TAUNT HABIT YACHT 
YEARN: SLATE BEADY YEARN 
YEAST: SLATE BEAST FEAST YEAST 
YIELD: SLATE LEVEL WIELD FIELD YIELD 
YOUNG: SLATE CRONY YOUNG 
YOUTH: SLATE MIRTH BOOTH YOUTH 
ZEBRA: SLATE RACER BREAK ZEBRA 
ZESTY: SLATE TESTY ZESTY 
ZONAL: SLATE CANAL ZONAL 
